"ABS","Àmbit","Indicador","ABS homes","ABS dones","ABS total","Catalunya homes","Catalunya dones","Catalunya total"
"Abrera","Demogràfic","Població assignada de 0-14 anys (n)",1042,944,1986,563490,531360,1094850
"Abrera","Demogràfic","Població assignada de 15-54 anys (n)",3487,3227,6714,2090135,2009939,4100074
"Abrera","Demogràfic","Població assignada de 55-64 anys (n)",726,681,1407,485653,501618,987271
"Abrera","Demogràfic","Població assignada de 65 anys o més (n)",902,1097,1999,631736,839322,1471058
"Abrera","Demogràfic","Població assignada total (n)",6157,5949,12106,3771014,3882239,7653253
"Agramunt","Demogràfic","Població assignada de 0-14 anys (n)",466,487,953,563490,531360,1094850
"Agramunt","Demogràfic","Població assignada de 15-54 anys (n)",1721,1507,3228,2090135,2009939,4100074
"Agramunt","Demogràfic","Població assignada de 55-64 anys (n)",493,421,914,485653,501618,987271
"Agramunt","Demogràfic","Població assignada de 65 anys o més (n)",637,767,1404,631736,839322,1471058
"Agramunt","Demogràfic","Població assignada total (n)",3317,3182,6499,3771014,3882239,7653253
"Alcarràs","Demogràfic","Població assignada de 0-14 anys (n)",1215,1112,2327,563490,531360,1094850
"Alcarràs","Demogràfic","Població assignada de 15-54 anys (n)",4426,3745,8171,2090135,2009939,4100074
"Alcarràs","Demogràfic","Població assignada de 55-64 anys (n)",943,735,1678,485653,501618,987271
"Alcarràs","Demogràfic","Població assignada de 65 anys o més (n)",946,1189,2135,631736,839322,1471058
"Alcarràs","Demogràfic","Població assignada total (n)",7530,6781,14311,3771014,3882239,7653253
"Alfarràs - Almenar","Demogràfic","Població assignada de 0-14 anys (n)",620,581,1201,563490,531360,1094850
"Alfarràs - Almenar","Demogràfic","Població assignada de 15-54 anys (n)",2728,2017,4745,2090135,2009939,4100074
"Alfarràs - Almenar","Demogràfic","Població assignada de 55-64 anys (n)",703,606,1309,485653,501618,987271
"Alfarràs - Almenar","Demogràfic","Població assignada de 65 anys o més (n)",1024,1233,2257,631736,839322,1471058
"Alfarràs - Almenar","Demogràfic","Població assignada total (n)",5075,4437,9512,3771014,3882239,7653253
"Almacelles","Demogràfic","Població assignada de 0-14 anys (n)",631,594,1225,563490,531360,1094850
"Almacelles","Demogràfic","Població assignada de 15-54 anys (n)",2550,2024,4574,2090135,2009939,4100074
"Almacelles","Demogràfic","Població assignada de 55-64 anys (n)",670,538,1208,485653,501618,987271
"Almacelles","Demogràfic","Població assignada de 65 anys o més (n)",848,1029,1877,631736,839322,1471058
"Almacelles","Demogràfic","Població assignada total (n)",4699,4185,8884,3771014,3882239,7653253
"Alt Berguedà","Demogràfic","Població assignada de 0-14 anys (n)",297,331,628,563490,531360,1094850
"Alt Berguedà","Demogràfic","Població assignada de 15-54 anys (n)",1072,906,1978,2090135,2009939,4100074
"Alt Berguedà","Demogràfic","Població assignada de 55-64 anys (n)",433,420,853,485653,501618,987271
"Alt Berguedà","Demogràfic","Població assignada de 65 anys o més (n)",638,781,1419,631736,839322,1471058
"Alt Berguedà","Demogràfic","Població assignada total (n)",2440,2438,4878,3771014,3882239,7653253
"Alt Camp Est","Demogràfic","Població assignada de 0-14 anys (n)",833,761,1594,563490,531360,1094850
"Alt Camp Est","Demogràfic","Població assignada de 15-54 anys (n)",3057,2614,5671,2090135,2009939,4100074
"Alt Camp Est","Demogràfic","Població assignada de 55-64 anys (n)",823,742,1565,485653,501618,987271
"Alt Camp Est","Demogràfic","Població assignada de 65 anys o més (n)",1166,1280,2446,631736,839322,1471058
"Alt Camp Est","Demogràfic","Població assignada total (n)",5879,5397,11276,3771014,3882239,7653253
"Alt Camp Oest","Demogràfic","Població assignada de 0-14 anys (n)",478,509,987,563490,531360,1094850
"Alt Camp Oest","Demogràfic","Població assignada de 15-54 anys (n)",1746,1592,3338,2090135,2009939,4100074
"Alt Camp Oest","Demogràfic","Població assignada de 55-64 anys (n)",463,424,887,485653,501618,987271
"Alt Camp Oest","Demogràfic","Població assignada de 65 anys o més (n)",558,643,1201,631736,839322,1471058
"Alt Camp Oest","Demogràfic","Població assignada total (n)",3245,3168,6413,3771014,3882239,7653253
"Alt Mogent","Demogràfic","Població assignada de 0-14 anys (n)",1534,1456,2990,563490,531360,1094850
"Alt Mogent","Demogràfic","Població assignada de 15-54 anys (n)",5511,5360,10871,2090135,2009939,4100074
"Alt Mogent","Demogràfic","Població assignada de 55-64 anys (n)",1420,1344,2764,485653,501618,987271
"Alt Mogent","Demogràfic","Població assignada de 65 anys o més (n)",1533,1986,3519,631736,839322,1471058
"Alt Mogent","Demogràfic","Població assignada total (n)",9998,10146,20144,3771014,3882239,7653253
"Alt Urgell Sud","Demogràfic","Població assignada de 0-14 anys (n)",216,209,425,563490,531360,1094850
"Alt Urgell Sud","Demogràfic","Població assignada de 15-54 anys (n)",885,759,1644,2090135,2009939,4100074
"Alt Urgell Sud","Demogràfic","Població assignada de 55-64 anys (n)",277,298,575,485653,501618,987271
"Alt Urgell Sud","Demogràfic","Població assignada de 65 anys o més (n)",508,592,1100,631736,839322,1471058
"Alt Urgell Sud","Demogràfic","Població assignada total (n)",1886,1858,3744,3771014,3882239,7653253
"Alta Ribagorça","Demogràfic","Població assignada de 0-14 anys (n)",247,193,440,563490,531360,1094850
"Alta Ribagorça","Demogràfic","Població assignada de 15-54 anys (n)",959,897,1856,2090135,2009939,4100074
"Alta Ribagorça","Demogràfic","Població assignada de 55-64 anys (n)",265,247,512,485653,501618,987271
"Alta Ribagorça","Demogràfic","Població assignada de 65 anys o més (n)",324,367,691,631736,839322,1471058
"Alta Ribagorça","Demogràfic","Població assignada total (n)",1795,1704,3499,3771014,3882239,7653253
"Amposta","Demogràfic","Població assignada de 0-14 anys (n)",2174,1963,4137,563490,531360,1094850
"Amposta","Demogràfic","Població assignada de 15-54 anys (n)",7710,6835,14545,2090135,2009939,4100074
"Amposta","Demogràfic","Població assignada de 55-64 anys (n)",1818,1741,3559,485653,501618,987271
"Amposta","Demogràfic","Població assignada de 65 anys o més (n)",2544,2993,5537,631736,839322,1471058
"Amposta","Demogràfic","Població assignada total (n)",14246,13532,27778,3771014,3882239,7653253
"Anglès","Demogràfic","Població assignada de 0-14 anys (n)",929,866,1795,563490,531360,1094850
"Anglès","Demogràfic","Població assignada de 15-54 anys (n)",3142,2944,6086,2090135,2009939,4100074
"Anglès","Demogràfic","Població assignada de 55-64 anys (n)",850,796,1646,485653,501618,987271
"Anglès","Demogràfic","Població assignada de 65 anys o més (n)",1132,1374,2506,631736,839322,1471058
"Anglès","Demogràfic","Població assignada total (n)",6053,5980,12033,3771014,3882239,7653253
"Anoia Rural","Demogràfic","Població assignada de 0-14 anys (n)",767,736,1503,563490,531360,1094850
"Anoia Rural","Demogràfic","Població assignada de 15-54 anys (n)",2523,2202,4725,2090135,2009939,4100074
"Anoia Rural","Demogràfic","Població assignada de 55-64 anys (n)",625,578,1203,485653,501618,987271
"Anoia Rural","Demogràfic","Població assignada de 65 anys o més (n)",884,1038,1922,631736,839322,1471058
"Anoia Rural","Demogràfic","Població assignada total (n)",4799,4554,9353,3771014,3882239,7653253
"Aran","Demogràfic","Població assignada de 0-14 anys (n)",675,638,1313,563490,531360,1094850
"Aran","Demogràfic","Població assignada de 15-54 anys (n)",2690,2629,5319,2090135,2009939,4100074
"Aran","Demogràfic","Població assignada de 55-64 anys (n)",718,663,1381,485653,501618,987271
"Aran","Demogràfic","Població assignada de 65 anys o més (n)",671,756,1427,631736,839322,1471058
"Aran","Demogràfic","Població assignada total (n)",4754,4686,9440,3771014,3882239,7653253
"Arbúcies - Sant Hilari Sacalm","Demogràfic","Població assignada de 0-14 anys (n)",951,959,1910,563490,531360,1094850
"Arbúcies - Sant Hilari Sacalm","Demogràfic","Població assignada de 15-54 anys (n)",3436,2870,6306,2090135,2009939,4100074
"Arbúcies - Sant Hilari Sacalm","Demogràfic","Població assignada de 55-64 anys (n)",881,823,1704,485653,501618,987271
"Arbúcies - Sant Hilari Sacalm","Demogràfic","Població assignada de 65 anys o més (n)",1147,1346,2493,631736,839322,1471058
"Arbúcies - Sant Hilari Sacalm","Demogràfic","Població assignada total (n)",6415,5998,12413,3771014,3882239,7653253
"Arenys de Mar","Demogràfic","Població assignada de 0-14 anys (n)",1804,1628,3432,563490,531360,1094850
"Arenys de Mar","Demogràfic","Població assignada de 15-54 anys (n)",6461,6118,12579,2090135,2009939,4100074
"Arenys de Mar","Demogràfic","Població assignada de 55-64 anys (n)",1608,1682,3290,485653,501618,987271
"Arenys de Mar","Demogràfic","Població assignada de 65 anys o més (n)",2156,3048,5204,631736,839322,1471058
"Arenys de Mar","Demogràfic","Població assignada total (n)",12029,12476,24505,3771014,3882239,7653253
"Argentona","Demogràfic","Població assignada de 0-14 anys (n)",1349,1291,2640,563490,531360,1094850
"Argentona","Demogràfic","Població assignada de 15-54 anys (n)",4729,4540,9269,2090135,2009939,4100074
"Argentona","Demogràfic","Població assignada de 55-64 anys (n)",1187,1201,2388,485653,501618,987271
"Argentona","Demogràfic","Població assignada de 65 anys o més (n)",1415,1721,3136,631736,839322,1471058
"Argentona","Demogràfic","Població assignada total (n)",8680,8753,17433,3771014,3882239,7653253
"Artés","Demogràfic","Població assignada de 0-14 anys (n)",814,733,1547,563490,531360,1094850
"Artés","Demogràfic","Població assignada de 15-54 anys (n)",2892,2639,5531,2090135,2009939,4100074
"Artés","Demogràfic","Població assignada de 55-64 anys (n)",802,769,1571,485653,501618,987271
"Artés","Demogràfic","Població assignada de 65 anys o més (n)",1091,1353,2444,631736,839322,1471058
"Artés","Demogràfic","Població assignada total (n)",5599,5494,11093,3771014,3882239,7653253
"Artesa de Segre","Demogràfic","Població assignada de 0-14 anys (n)",306,272,578,563490,531360,1094850
"Artesa de Segre","Demogràfic","Població assignada de 15-54 anys (n)",1174,924,2098,2090135,2009939,4100074
"Artesa de Segre","Demogràfic","Població assignada de 55-64 anys (n)",286,234,520,485653,501618,987271
"Artesa de Segre","Demogràfic","Població assignada de 65 anys o més (n)",430,481,911,631736,839322,1471058
"Artesa de Segre","Demogràfic","Població assignada total (n)",2196,1911,4107,3771014,3882239,7653253
"Badalona 01 - Martí i Julià","Demogràfic","Població assignada de 0-14 anys (n)",921,878,1799,563490,531360,1094850
"Badalona 01 - Martí i Julià","Demogràfic","Població assignada de 15-54 anys (n)",3231,3223,6454,2090135,2009939,4100074
"Badalona 01 - Martí i Julià","Demogràfic","Població assignada de 55-64 anys (n)",793,849,1642,485653,501618,987271
"Badalona 01 - Martí i Julià","Demogràfic","Població assignada de 65 anys o més (n)",1125,1548,2673,631736,839322,1471058
"Badalona 01 - Martí i Julià","Demogràfic","Població assignada total (n)",6070,6498,12568,3771014,3882239,7653253
"Badalona 02 - Centre - Dalt la Vila","Demogràfic","Població assignada de 0-14 anys (n)",1128,1130,2258,563490,531360,1094850
"Badalona 02 - Centre - Dalt la Vila","Demogràfic","Població assignada de 15-54 anys (n)",4144,4308,8452,2090135,2009939,4100074
"Badalona 02 - Centre - Dalt la Vila","Demogràfic","Població assignada de 55-64 anys (n)",1089,1342,2431,485653,501618,987271
"Badalona 02 - Centre - Dalt la Vila","Demogràfic","Població assignada de 65 anys o més (n)",1735,2474,4209,631736,839322,1471058
"Badalona 02 - Centre - Dalt la Vila","Demogràfic","Població assignada total (n)",8096,9254,17350,3771014,3882239,7653253
"Badalona 03 - Progrés - Raval","Demogràfic","Població assignada de 0-14 anys (n)",1873,1726,3599,563490,531360,1094850
"Badalona 03 - Progrés - Raval","Demogràfic","Població assignada de 15-54 anys (n)",5918,5896,11814,2090135,2009939,4100074
"Badalona 03 - Progrés - Raval","Demogràfic","Població assignada de 55-64 anys (n)",1279,1388,2667,485653,501618,987271
"Badalona 03 - Progrés - Raval","Demogràfic","Població assignada de 65 anys o més (n)",1731,2277,4008,631736,839322,1471058
"Badalona 03 - Progrés - Raval","Demogràfic","Població assignada total (n)",10801,11287,22088,3771014,3882239,7653253
"Badalona 04 - Gorg","Demogràfic","Població assignada de 0-14 anys (n)",599,558,1157,563490,531360,1094850
"Badalona 04 - Gorg","Demogràfic","Població assignada de 15-54 anys (n)",2329,2311,4640,2090135,2009939,4100074
"Badalona 04 - Gorg","Demogràfic","Població assignada de 55-64 anys (n)",634,667,1301,485653,501618,987271
"Badalona 04 - Gorg","Demogràfic","Població assignada de 65 anys o més (n)",991,1311,2302,631736,839322,1471058
"Badalona 04 - Gorg","Demogràfic","Població assignada total (n)",4553,4847,9400,3771014,3882239,7653253
"Badalona 05 - Sant Roc","Demogràfic","Població assignada de 0-14 anys (n)",1543,1522,3065,563490,531360,1094850
"Badalona 05 - Sant Roc","Demogràfic","Població assignada de 15-54 anys (n)",5982,4273,10255,2090135,2009939,4100074
"Badalona 05 - Sant Roc","Demogràfic","Població assignada de 55-64 anys (n)",1011,974,1985,485653,501618,987271
"Badalona 05 - Sant Roc","Demogràfic","Població assignada de 65 anys o més (n)",972,1277,2249,631736,839322,1471058
"Badalona 05 - Sant Roc","Demogràfic","Població assignada total (n)",9508,8046,17554,3771014,3882239,7653253
"Badalona 06 - Llefià","Demogràfic","Població assignada de 0-14 anys (n)",1723,1599,3322,563490,531360,1094850
"Badalona 06 - Llefià","Demogràfic","Població assignada de 15-54 anys (n)",6596,6199,12795,2090135,2009939,4100074
"Badalona 06 - Llefià","Demogràfic","Població assignada de 55-64 anys (n)",1458,1760,3218,485653,501618,987271
"Badalona 06 - Llefià","Demogràfic","Població assignada de 65 anys o més (n)",2526,3239,5765,631736,839322,1471058
"Badalona 06 - Llefià","Demogràfic","Població assignada total (n)",12303,12797,25100,3771014,3882239,7653253
"Badalona 07A - Gran Sol","Demogràfic","Població assignada de 0-14 anys (n)",3179,2930,6109,563490,531360,1094850
"Badalona 07A - Gran Sol","Demogràfic","Població assignada de 15-54 anys (n)",5521,5217,10738,2090135,2009939,4100074
"Badalona 07A - Gran Sol","Demogràfic","Població assignada de 55-64 anys (n)",1099,1171,2270,485653,501618,987271
"Badalona 07A - Gran Sol","Demogràfic","Població assignada de 65 anys o més (n)",1617,2117,3734,631736,839322,1471058
"Badalona 07A - Gran Sol","Demogràfic","Població assignada total (n)",11416,11435,22851,3771014,3882239,7653253
"Badalona 07B - La Salut","Demogràfic","Població assignada de 0-14 anys (n)",35,24,59,563490,531360,1094850
"Badalona 07B - La Salut","Demogràfic","Població assignada de 15-54 anys (n)",5504,4711,10215,2090135,2009939,4100074
"Badalona 07B - La Salut","Demogràfic","Població assignada de 55-64 anys (n)",1029,956,1985,485653,501618,987271
"Badalona 07B - La Salut","Demogràfic","Població assignada de 65 anys o més (n)",1149,1630,2779,631736,839322,1471058
"Badalona 07B - La Salut","Demogràfic","Població assignada total (n)",7717,7321,15038,3771014,3882239,7653253
"Badalona 08 - Nova Lloreda","Demogràfic","Població assignada de 0-14 anys (n)",989,920,1909,563490,531360,1094850
"Badalona 08 - Nova Lloreda","Demogràfic","Població assignada de 15-54 anys (n)",3686,3550,7236,2090135,2009939,4100074
"Badalona 08 - Nova Lloreda","Demogràfic","Població assignada de 55-64 anys (n)",909,1027,1936,485653,501618,987271
"Badalona 08 - Nova Lloreda","Demogràfic","Població assignada de 65 anys o més (n)",1364,1714,3078,631736,839322,1471058
"Badalona 08 - Nova Lloreda","Demogràfic","Població assignada total (n)",6948,7211,14159,3771014,3882239,7653253
"Badalona 09 - Apenins - Montigalà","Demogràfic","Població assignada de 0-14 anys (n)",1329,1228,2557,563490,531360,1094850
"Badalona 09 - Apenins - Montigalà","Demogràfic","Població assignada de 15-54 anys (n)",5009,4676,9685,2090135,2009939,4100074
"Badalona 09 - Apenins - Montigalà","Demogràfic","Població assignada de 55-64 anys (n)",1260,1258,2518,485653,501618,987271
"Badalona 09 - Apenins - Montigalà","Demogràfic","Població assignada de 65 anys o més (n)",1518,1809,3327,631736,839322,1471058
"Badalona 09 - Apenins - Montigalà","Demogràfic","Població assignada total (n)",9116,8971,18087,3771014,3882239,7653253
"Badalona 10 - Nova Lloreda","Demogràfic","Població assignada de 0-14 anys (n)",851,820,1671,563490,531360,1094850
"Badalona 10 - Nova Lloreda","Demogràfic","Població assignada de 15-54 anys (n)",3185,3026,6211,2090135,2009939,4100074
"Badalona 10 - Nova Lloreda","Demogràfic","Població assignada de 55-64 anys (n)",672,744,1416,485653,501618,987271
"Badalona 10 - Nova Lloreda","Demogràfic","Població assignada de 65 anys o més (n)",1087,1424,2511,631736,839322,1471058
"Badalona 10 - Nova Lloreda","Demogràfic","Població assignada total (n)",5795,6014,11809,3771014,3882239,7653253
"Badalona 11 - Bufalà - Canyet","Demogràfic","Població assignada de 0-14 anys (n)",1687,1638,3325,563490,531360,1094850
"Badalona 11 - Bufalà - Canyet","Demogràfic","Població assignada de 15-54 anys (n)",6375,6241,12616,2090135,2009939,4100074
"Badalona 11 - Bufalà - Canyet","Demogràfic","Població assignada de 55-64 anys (n)",1588,1598,3186,485653,501618,987271
"Badalona 11 - Bufalà - Canyet","Demogràfic","Població assignada de 65 anys o més (n)",1641,2052,3693,631736,839322,1471058
"Badalona 11 - Bufalà - Canyet","Demogràfic","Població assignada total (n)",11291,11529,22820,3771014,3882239,7653253
"Badalona 12 - Morera - Pomar","Demogràfic","Població assignada de 0-14 anys (n)",850,775,1625,563490,531360,1094850
"Badalona 12 - Morera - Pomar","Demogràfic","Població assignada de 15-54 anys (n)",2931,2944,5875,2090135,2009939,4100074
"Badalona 12 - Morera - Pomar","Demogràfic","Població assignada de 55-64 anys (n)",782,774,1556,485653,501618,987271
"Badalona 12 - Morera - Pomar","Demogràfic","Població assignada de 65 anys o més (n)",1006,1370,2376,631736,839322,1471058
"Badalona 12 - Morera - Pomar","Demogràfic","Població assignada total (n)",5569,5863,11432,3771014,3882239,7653253
"Badia del Vallès","Demogràfic","Població assignada de 0-14 anys (n)",1081,1012,2093,563490,531360,1094850
"Badia del Vallès","Demogràfic","Població assignada de 15-54 anys (n)",4183,3950,8133,2090135,2009939,4100074
"Badia del Vallès","Demogràfic","Població assignada de 55-64 anys (n)",927,949,1876,485653,501618,987271
"Badia del Vallès","Demogràfic","Població assignada de 65 anys o més (n)",1191,1726,2917,631736,839322,1471058
"Badia del Vallès","Demogràfic","Població assignada total (n)",7382,7637,15019,3771014,3882239,7653253
"Baix Berguedà","Demogràfic","Població assignada de 0-14 anys (n)",796,725,1521,563490,531360,1094850
"Baix Berguedà","Demogràfic","Població assignada de 15-54 anys (n)",2816,2618,5434,2090135,2009939,4100074
"Baix Berguedà","Demogràfic","Població assignada de 55-64 anys (n)",888,857,1745,485653,501618,987271
"Baix Berguedà","Demogràfic","Població assignada de 65 anys o més (n)",1376,1781,3157,631736,839322,1471058
"Baix Berguedà","Demogràfic","Població assignada total (n)",5876,5981,11857,3771014,3882239,7653253
"Baix Penedès Interior","Demogràfic","Població assignada de 0-14 anys (n)",1238,1174,2412,563490,531360,1094850
"Baix Penedès Interior","Demogràfic","Població assignada de 15-54 anys (n)",4090,3657,7747,2090135,2009939,4100074
"Baix Penedès Interior","Demogràfic","Població assignada de 55-64 anys (n)",1012,886,1898,485653,501618,987271
"Baix Penedès Interior","Demogràfic","Població assignada de 65 anys o més (n)",1234,1483,2717,631736,839322,1471058
"Baix Penedès Interior","Demogràfic","Població assignada total (n)",7574,7200,14774,3771014,3882239,7653253
"Balaguer","Demogràfic","Població assignada de 0-14 anys (n)",2132,1986,4118,563490,531360,1094850
"Balaguer","Demogràfic","Població assignada de 15-54 anys (n)",7645,6318,13963,2090135,2009939,4100074
"Balaguer","Demogràfic","Població assignada de 55-64 anys (n)",2033,1754,3787,485653,501618,987271
"Balaguer","Demogràfic","Població assignada de 65 anys o més (n)",2593,3211,5804,631736,839322,1471058
"Balaguer","Demogràfic","Població assignada total (n)",14403,13269,27672,3771014,3882239,7653253
"Banyoles","Demogràfic","Població assignada de 0-14 anys (n)",2646,2456,5102,563490,531360,1094850
"Banyoles","Demogràfic","Població assignada de 15-54 anys (n)",8557,8034,16591,2090135,2009939,4100074
"Banyoles","Demogràfic","Població assignada de 55-64 anys (n)",2169,2009,4178,485653,501618,987271
"Banyoles","Demogràfic","Població assignada de 65 anys o més (n)",2712,3445,6157,631736,839322,1471058
"Banyoles","Demogràfic","Població assignada total (n)",16084,15944,32028,3771014,3882239,7653253
"Barberà del Vallès","Demogràfic","Població assignada de 0-14 anys (n)",2511,2359,4870,563490,531360,1094850
"Barberà del Vallès","Demogràfic","Població assignada de 15-54 anys (n)",8175,8033,16208,2090135,2009939,4100074
"Barberà del Vallès","Demogràfic","Població assignada de 55-64 anys (n)",1838,1924,3762,485653,501618,987271
"Barberà del Vallès","Demogràfic","Població assignada de 65 anys o més (n)",2354,3079,5433,631736,839322,1471058
"Barberà del Vallès","Demogràfic","Població assignada total (n)",14878,15395,30273,3771014,3882239,7653253
"Barcelona 01A - Barceloneta","Demogràfic","Població assignada de 0-14 anys (n)",649,665,1314,563490,531360,1094850
"Barcelona 01A - Barceloneta","Demogràfic","Població assignada de 15-54 anys (n)",5362,4844,10206,2090135,2009939,4100074
"Barcelona 01A - Barceloneta","Demogràfic","Població assignada de 55-64 anys (n)",903,895,1798,485653,501618,987271
"Barcelona 01A - Barceloneta","Demogràfic","Població assignada de 65 anys o més (n)",999,1554,2553,631736,839322,1471058
"Barcelona 01A - Barceloneta","Demogràfic","Població assignada total (n)",7913,7958,15871,3771014,3882239,7653253
"Barcelona 01B - Casc Antic","Demogràfic","Població assignada de 0-14 anys (n)",1490,1309,2799,563490,531360,1094850
"Barcelona 01B - Casc Antic","Demogràfic","Població assignada de 15-54 anys (n)",8615,8043,16658,2090135,2009939,4100074
"Barcelona 01B - Casc Antic","Demogràfic","Població assignada de 55-64 anys (n)",1185,1214,2399,485653,501618,987271
"Barcelona 01B - Casc Antic","Demogràfic","Població assignada de 65 anys o més (n)",1262,1764,3026,631736,839322,1471058
"Barcelona 01B - Casc Antic","Demogràfic","Població assignada total (n)",12552,12330,24882,3771014,3882239,7653253
"Barcelona 01C - Gòtic","Demogràfic","Població assignada de 0-14 anys (n)",479,472,951,563490,531360,1094850
"Barcelona 01C - Gòtic","Demogràfic","Població assignada de 15-54 anys (n)",6233,5405,11638,2090135,2009939,4100074
"Barcelona 01C - Gòtic","Demogràfic","Població assignada de 55-64 anys (n)",970,834,1804,485653,501618,987271
"Barcelona 01C - Gòtic","Demogràfic","Població assignada de 65 anys o més (n)",962,1141,2103,631736,839322,1471058
"Barcelona 01C - Gòtic","Demogràfic","Població assignada total (n)",8644,7852,16496,3771014,3882239,7653253
"Barcelona 01D - Raval Sud","Demogràfic","Població assignada de 0-14 anys (n)",2480,2289,4769,563490,531360,1094850
"Barcelona 01D - Raval Sud","Demogràfic","Població assignada de 15-54 anys (n)",13548,8217,21765,2090135,2009939,4100074
"Barcelona 01D - Raval Sud","Demogràfic","Població assignada de 55-64 anys (n)",1666,1151,2817,485653,501618,987271
"Barcelona 01D - Raval Sud","Demogràfic","Població assignada de 65 anys o més (n)",1355,1459,2814,631736,839322,1471058
"Barcelona 01D - Raval Sud","Demogràfic","Població assignada total (n)",19049,13116,32165,3771014,3882239,7653253
"Barcelona 01E - Raval Nord - Dr. Sayé","Demogràfic","Població assignada de 0-14 anys (n)",925,861,1786,563490,531360,1094850
"Barcelona 01E - Raval Nord - Dr. Sayé","Demogràfic","Població assignada de 15-54 anys (n)",7909,6539,14448,2090135,2009939,4100074
"Barcelona 01E - Raval Nord - Dr. Sayé","Demogràfic","Població assignada de 55-64 anys (n)",1189,1248,2437,485653,501618,987271
"Barcelona 01E - Raval Nord - Dr. Sayé","Demogràfic","Població assignada de 65 anys o més (n)",1007,1570,2577,631736,839322,1471058
"Barcelona 01E - Raval Nord - Dr. Sayé","Demogràfic","Població assignada total (n)",11030,10218,21248,3771014,3882239,7653253
"Barcelona 02A - Sant Antoni","Demogràfic","Població assignada de 0-14 anys (n)",1712,1525,3237,563490,531360,1094850
"Barcelona 02A - Sant Antoni","Demogràfic","Població assignada de 15-54 anys (n)",9702,9492,19194,2090135,2009939,4100074
"Barcelona 02A - Sant Antoni","Demogràfic","Població assignada de 55-64 anys (n)",1972,2257,4229,485653,501618,987271
"Barcelona 02A - Sant Antoni","Demogràfic","Població assignada de 65 anys o més (n)",2788,4291,7079,631736,839322,1471058
"Barcelona 02A - Sant Antoni","Demogràfic","Població assignada total (n)",16174,17565,33739,3771014,3882239,7653253
"Barcelona 02B - Via Roma","Demogràfic","Població assignada de 0-14 anys (n)",1025,925,1950,563490,531360,1094850
"Barcelona 02B - Via Roma","Demogràfic","Població assignada de 15-54 anys (n)",7818,8048,15866,2090135,2009939,4100074
"Barcelona 02B - Via Roma","Demogràfic","Població assignada de 55-64 anys (n)",1585,2039,3624,485653,501618,987271
"Barcelona 02B - Via Roma","Demogràfic","Població assignada de 65 anys o més (n)",2523,3705,6228,631736,839322,1471058
"Barcelona 02B - Via Roma","Demogràfic","Població assignada total (n)",12951,14717,27668,3771014,3882239,7653253
"Barcelona 02C - Esq. Eixample - Comte Borrell","Demogràfic","Població assignada de 0-14 anys (n)",1537,1396,2933,563490,531360,1094850
"Barcelona 02C - Esq. Eixample - Comte Borrell","Demogràfic","Població assignada de 15-54 anys (n)",8517,8881,17398,2090135,2009939,4100074
"Barcelona 02C - Esq. Eixample - Comte Borrell","Demogràfic","Població assignada de 55-64 anys (n)",1884,2350,4234,485653,501618,987271
"Barcelona 02C - Esq. Eixample - Comte Borrell","Demogràfic","Població assignada de 65 anys o més (n)",3166,4597,7763,631736,839322,1471058
"Barcelona 02C - Esq. Eixample - Comte Borrell","Demogràfic","Població assignada total (n)",15104,17224,32328,3771014,3882239,7653253
"Barcelona 02D - Universitat","Demogràfic","Població assignada de 0-14 anys (n)",1394,1351,2745,563490,531360,1094850
"Barcelona 02D - Universitat","Demogràfic","Població assignada de 15-54 anys (n)",6478,5589,12067,2090135,2009939,4100074
"Barcelona 02D - Universitat","Demogràfic","Població assignada de 55-64 anys (n)",1105,1129,2234,485653,501618,987271
"Barcelona 02D - Universitat","Demogràfic","Població assignada de 65 anys o més (n)",1418,2250,3668,631736,839322,1471058
"Barcelona 02D - Universitat","Demogràfic","Població assignada total (n)",10395,10319,20714,3771014,3882239,7653253
"Barcelona 02E - Esq. Eixample - Casanova","Demogràfic","Població assignada de 0-14 anys (n)",2325,2152,4477,563490,531360,1094850
"Barcelona 02E - Esq. Eixample - Casanova","Demogràfic","Població assignada de 15-54 anys (n)",9959,11138,21097,2090135,2009939,4100074
"Barcelona 02E - Esq. Eixample - Casanova","Demogràfic","Població assignada de 55-64 anys (n)",2189,2629,4818,485653,501618,987271
"Barcelona 02E - Esq. Eixample - Casanova","Demogràfic","Població assignada de 65 anys o més (n)",2922,4491,7413,631736,839322,1471058
"Barcelona 02E - Esq. Eixample - Casanova","Demogràfic","Població assignada total (n)",17395,20410,37805,3771014,3882239,7653253
"Barcelona 02G - Dreta Eixample","Demogràfic","Població assignada de 0-14 anys (n)",1653,1460,3113,563490,531360,1094850
"Barcelona 02G - Dreta Eixample","Demogràfic","Població assignada de 15-54 anys (n)",5906,6293,12199,2090135,2009939,4100074
"Barcelona 02G - Dreta Eixample","Demogràfic","Població assignada de 55-64 anys (n)",1327,1529,2856,485653,501618,987271
"Barcelona 02G - Dreta Eixample","Demogràfic","Població assignada de 65 anys o més (n)",1966,3346,5312,631736,839322,1471058
"Barcelona 02G - Dreta Eixample","Demogràfic","Població assignada total (n)",10852,12628,23480,3771014,3882239,7653253
"Barcelona 02H - Passeig Sant Joan","Demogràfic","Població assignada de 0-14 anys (n)",1206,1149,2355,563490,531360,1094850
"Barcelona 02H - Passeig Sant Joan","Demogràfic","Població assignada de 15-54 anys (n)",8166,8001,16167,2090135,2009939,4100074
"Barcelona 02H - Passeig Sant Joan","Demogràfic","Població assignada de 55-64 anys (n)",1789,2100,3889,485653,501618,987271
"Barcelona 02H - Passeig Sant Joan","Demogràfic","Població assignada de 65 anys o més (n)",2907,4164,7071,631736,839322,1471058
"Barcelona 02H - Passeig Sant Joan","Demogràfic","Població assignada total (n)",14068,15414,29482,3771014,3882239,7653253
"Barcelona 02I - Sagrada Família","Demogràfic","Població assignada de 0-14 anys (n)",1383,1364,2747,563490,531360,1094850
"Barcelona 02I - Sagrada Família","Demogràfic","Població assignada de 15-54 anys (n)",5760,6211,11971,2090135,2009939,4100074
"Barcelona 02I - Sagrada Família","Demogràfic","Població assignada de 55-64 anys (n)",1300,1502,2802,485653,501618,987271
"Barcelona 02I - Sagrada Família","Demogràfic","Població assignada de 65 anys o més (n)",1856,2905,4761,631736,839322,1471058
"Barcelona 02I - Sagrada Família","Demogràfic","Població assignada total (n)",10299,11982,22281,3771014,3882239,7653253
"Barcelona 02J - Monumental","Demogràfic","Població assignada de 0-14 anys (n)",1744,1710,3454,563490,531360,1094850
"Barcelona 02J - Monumental","Demogràfic","Població assignada de 15-54 anys (n)",7940,8825,16765,2090135,2009939,4100074
"Barcelona 02J - Monumental","Demogràfic","Població assignada de 55-64 anys (n)",1482,1698,3180,485653,501618,987271
"Barcelona 02J - Monumental","Demogràfic","Població assignada de 65 anys o més (n)",1982,2904,4886,631736,839322,1471058
"Barcelona 02J - Monumental","Demogràfic","Població assignada total (n)",13148,15137,28285,3771014,3882239,7653253
"Barcelona 02K - Sagrada Família","Demogràfic","Població assignada de 0-14 anys (n)",1042,958,2000,563490,531360,1094850
"Barcelona 02K - Sagrada Família","Demogràfic","Població assignada de 15-54 anys (n)",7196,7818,15014,2090135,2009939,4100074
"Barcelona 02K - Sagrada Família","Demogràfic","Població assignada de 55-64 anys (n)",1614,1933,3547,485653,501618,987271
"Barcelona 02K - Sagrada Família","Demogràfic","Població assignada de 65 anys o més (n)",2342,3664,6006,631736,839322,1471058
"Barcelona 02K - Sagrada Família","Demogràfic","Població assignada total (n)",12194,14373,26567,3771014,3882239,7653253
"Barcelona 03A - Les Hortes - Poble Sec","Demogràfic","Població assignada de 0-14 anys (n)",1409,1295,2704,563490,531360,1094850
"Barcelona 03A - Les Hortes - Poble Sec","Demogràfic","Població assignada de 15-54 anys (n)",7920,7166,15086,2090135,2009939,4100074
"Barcelona 03A - Les Hortes - Poble Sec","Demogràfic","Població assignada de 55-64 anys (n)",1351,1387,2738,485653,501618,987271
"Barcelona 03A - Les Hortes - Poble Sec","Demogràfic","Població assignada de 65 anys o més (n)",1477,2111,3588,631736,839322,1471058
"Barcelona 03A - Les Hortes - Poble Sec","Demogràfic","Població assignada total (n)",12157,11959,24116,3771014,3882239,7653253
"Barcelona 03B - Poble Sec - Montjuïc","Demogràfic","Població assignada de 0-14 anys (n)",793,722,1515,563490,531360,1094850
"Barcelona 03B - Poble Sec - Montjuïc","Demogràfic","Població assignada de 15-54 anys (n)",6959,6578,13537,2090135,2009939,4100074
"Barcelona 03B - Poble Sec - Montjuïc","Demogràfic","Població assignada de 55-64 anys (n)",1298,1507,2805,485653,501618,987271
"Barcelona 03B - Poble Sec - Montjuïc","Demogràfic","Població assignada de 65 anys o més (n)",1857,2815,4672,631736,839322,1471058
"Barcelona 03B - Poble Sec - Montjuïc","Demogràfic","Població assignada total (n)",10907,11622,22529,3771014,3882239,7653253
"Barcelona 03C - Dr. Carles Riba","Demogràfic","Població assignada de 0-14 anys (n)",809,802,1611,563490,531360,1094850
"Barcelona 03C - Dr. Carles Riba","Demogràfic","Població assignada de 15-54 anys (n)",3836,3474,7310,2090135,2009939,4100074
"Barcelona 03C - Dr. Carles Riba","Demogràfic","Població assignada de 55-64 anys (n)",1101,1159,2260,485653,501618,987271
"Barcelona 03C - Dr. Carles Riba","Demogràfic","Població assignada de 65 anys o més (n)",1411,1809,3220,631736,839322,1471058
"Barcelona 03C - Dr. Carles Riba","Demogràfic","Població assignada total (n)",7157,7244,14401,3771014,3882239,7653253
"Barcelona 03D - Bordeta","Demogràfic","Població assignada de 0-14 anys (n)",1921,1848,3769,563490,531360,1094850
"Barcelona 03D - Bordeta","Demogràfic","Població assignada de 15-54 anys (n)",8983,9003,17986,2090135,2009939,4100074
"Barcelona 03D - Bordeta","Demogràfic","Població assignada de 55-64 anys (n)",2039,2246,4285,485653,501618,987271
"Barcelona 03D - Bordeta","Demogràfic","Població assignada de 65 anys o més (n)",2752,4014,6766,631736,839322,1471058
"Barcelona 03D - Bordeta","Demogràfic","Població assignada total (n)",15695,17111,32806,3771014,3882239,7653253
"Barcelona 03E - Sants","Demogràfic","Població assignada de 0-14 anys (n)",2780,2590,5370,563490,531360,1094850
"Barcelona 03E - Sants","Demogràfic","Població assignada de 15-54 anys (n)",6946,7311,14257,2090135,2009939,4100074
"Barcelona 03E - Sants","Demogràfic","Població assignada de 55-64 anys (n)",1470,1655,3125,485653,501618,987271
"Barcelona 03E - Sants","Demogràfic","Població assignada de 65 anys o més (n)",1781,2707,4488,631736,839322,1471058
"Barcelona 03E - Sants","Demogràfic","Població assignada total (n)",12977,14263,27240,3771014,3882239,7653253
"Barcelona 03G - Numància","Demogràfic","Població assignada de 0-14 anys (n)",1619,1558,3177,563490,531360,1094850
"Barcelona 03G - Numància","Demogràfic","Població assignada de 15-54 anys (n)",6725,6974,13699,2090135,2009939,4100074
"Barcelona 03G - Numància","Demogràfic","Població assignada de 55-64 anys (n)",1392,1681,3073,485653,501618,987271
"Barcelona 03G - Numància","Demogràfic","Població assignada de 65 anys o més (n)",2396,3366,5762,631736,839322,1471058
"Barcelona 03G - Numància","Demogràfic","Població assignada total (n)",12132,13579,25711,3771014,3882239,7653253
"Barcelona 03H - La Marina","Demogràfic","Població assignada de 0-14 anys (n)",1421,1273,2694,563490,531360,1094850
"Barcelona 03H - La Marina","Demogràfic","Població assignada de 15-54 anys (n)",5366,5407,10773,2090135,2009939,4100074
"Barcelona 03H - La Marina","Demogràfic","Població assignada de 55-64 anys (n)",1280,1426,2706,485653,501618,987271
"Barcelona 03H - La Marina","Demogràfic","Població assignada de 65 anys o més (n)",1477,2163,3640,631736,839322,1471058
"Barcelona 03H - La Marina","Demogràfic","Població assignada total (n)",9544,10269,19813,3771014,3882239,7653253
"Barcelona 03I - Badal","Demogràfic","Població assignada de 0-14 anys (n)",344,326,670,563490,531360,1094850
"Barcelona 03I - Badal","Demogràfic","Població assignada de 15-54 anys (n)",5846,6117,11963,2090135,2009939,4100074
"Barcelona 03I - Badal","Demogràfic","Població assignada de 55-64 anys (n)",1255,1565,2820,485653,501618,987271
"Barcelona 03I - Badal","Demogràfic","Població assignada de 65 anys o més (n)",1966,2898,4864,631736,839322,1471058
"Barcelona 03I - Badal","Demogràfic","Població assignada total (n)",9411,10906,20317,3771014,3882239,7653253
"Barcelona 04A - Montnegre","Demogràfic","Població assignada de 0-14 anys (n)",1344,1344,2688,563490,531360,1094850
"Barcelona 04A - Montnegre","Demogràfic","Població assignada de 15-54 anys (n)",6614,6894,13508,2090135,2009939,4100074
"Barcelona 04A - Montnegre","Demogràfic","Població assignada de 55-64 anys (n)",1629,2063,3692,485653,501618,987271
"Barcelona 04A - Montnegre","Demogràfic","Població assignada de 65 anys o més (n)",3022,4344,7366,631736,839322,1471058
"Barcelona 04A - Montnegre","Demogràfic","Població assignada total (n)",12609,14645,27254,3771014,3882239,7653253
"Barcelona 04B - Les Corts - Pedralbes","Demogràfic","Població assignada de 0-14 anys (n)",1244,1101,2345,563490,531360,1094850
"Barcelona 04B - Les Corts - Pedralbes","Demogràfic","Població assignada de 15-54 anys (n)",4680,5060,9740,2090135,2009939,4100074
"Barcelona 04B - Les Corts - Pedralbes","Demogràfic","Població assignada de 55-64 anys (n)",1122,1384,2506,485653,501618,987271
"Barcelona 04B - Les Corts - Pedralbes","Demogràfic","Població assignada de 65 anys o més (n)",2255,3174,5429,631736,839322,1471058
"Barcelona 04B - Les Corts - Pedralbes","Demogràfic","Població assignada total (n)",9301,10719,20020,3771014,3882239,7653253
"Barcelona 04C - Les Corts - Helios","Demogràfic","Població assignada de 0-14 anys (n)",1422,1377,2799,563490,531360,1094850
"Barcelona 04C - Les Corts - Helios","Demogràfic","Població assignada de 15-54 anys (n)",7888,8599,16487,2090135,2009939,4100074
"Barcelona 04C - Les Corts - Helios","Demogràfic","Població assignada de 55-64 anys (n)",1832,2274,4106,485653,501618,987271
"Barcelona 04C - Les Corts - Helios","Demogràfic","Població assignada de 65 anys o més (n)",3483,4839,8322,631736,839322,1471058
"Barcelona 04C - Les Corts - Helios","Demogràfic","Població assignada total (n)",14625,17089,31714,3771014,3882239,7653253
"Barcelona 05A - Marc Aureli","Demogràfic","Població assignada de 0-14 anys (n)",2147,2177,4324,563490,531360,1094850
"Barcelona 05A - Marc Aureli","Demogràfic","Població assignada de 15-54 anys (n)",7326,8628,15954,2090135,2009939,4100074
"Barcelona 05A - Marc Aureli","Demogràfic","Població assignada de 55-64 anys (n)",1865,2302,4167,485653,501618,987271
"Barcelona 05A - Marc Aureli","Demogràfic","Població assignada de 65 anys o més (n)",2645,4175,6820,631736,839322,1471058
"Barcelona 05A - Marc Aureli","Demogràfic","Població assignada total (n)",13983,17282,31265,3771014,3882239,7653253
"Barcelona 05B - Sant Elies","Demogràfic","Població assignada de 0-14 anys (n)",2506,2392,4898,563490,531360,1094850
"Barcelona 05B - Sant Elies","Demogràfic","Població assignada de 15-54 anys (n)",8747,10137,18884,2090135,2009939,4100074
"Barcelona 05B - Sant Elies","Demogràfic","Població assignada de 55-64 anys (n)",2261,2740,5001,485653,501618,987271
"Barcelona 05B - Sant Elies","Demogràfic","Població assignada de 65 anys o més (n)",3074,4886,7960,631736,839322,1471058
"Barcelona 05B - Sant Elies","Demogràfic","Població assignada total (n)",16588,20155,36743,3771014,3882239,7653253
"Barcelona 05C - Sarrià","Demogràfic","Població assignada de 0-14 anys (n)",3008,2874,5882,563490,531360,1094850
"Barcelona 05C - Sarrià","Demogràfic","Població assignada de 15-54 anys (n)",5358,5670,11028,2090135,2009939,4100074
"Barcelona 05C - Sarrià","Demogràfic","Població assignada de 55-64 anys (n)",1456,1642,3098,485653,501618,987271
"Barcelona 05C - Sarrià","Demogràfic","Població assignada de 65 anys o més (n)",1900,2823,4723,631736,839322,1471058
"Barcelona 05C - Sarrià","Demogràfic","Població assignada total (n)",11722,13009,24731,3771014,3882239,7653253
"Barcelona 05D - Vallvidrera - Les Planes","Demogràfic","Població assignada de 0-14 anys (n)",715,635,1350,563490,531360,1094850
"Barcelona 05D - Vallvidrera - Les Planes","Demogràfic","Població assignada de 15-54 anys (n)",5928,6515,12443,2090135,2009939,4100074
"Barcelona 05D - Vallvidrera - Les Planes","Demogràfic","Població assignada de 55-64 anys (n)",1462,1712,3174,485653,501618,987271
"Barcelona 05D - Vallvidrera - Les Planes","Demogràfic","Població assignada de 65 anys o més (n)",2287,3303,5590,631736,839322,1471058
"Barcelona 05D - Vallvidrera - Les Planes","Demogràfic","Població assignada total (n)",10392,12165,22557,3771014,3882239,7653253
"Barcelona 05E - Sant Gervasi","Demogràfic","Població assignada de 0-14 anys (n)",1806,1834,3640,563490,531360,1094850
"Barcelona 05E - Sant Gervasi","Demogràfic","Població assignada de 15-54 anys (n)",7584,8132,15716,2090135,2009939,4100074
"Barcelona 05E - Sant Gervasi","Demogràfic","Població assignada de 55-64 anys (n)",1869,2202,4071,485653,501618,987271
"Barcelona 05E - Sant Gervasi","Demogràfic","Població assignada de 65 anys o més (n)",3007,4461,7468,631736,839322,1471058
"Barcelona 05E - Sant Gervasi","Demogràfic","Població assignada total (n)",14266,16629,30895,3771014,3882239,7653253
"Barcelona 06A - Joanic","Demogràfic","Població assignada de 0-14 anys (n)",1732,1643,3375,563490,531360,1094850
"Barcelona 06A - Joanic","Demogràfic","Població assignada de 15-54 anys (n)",7938,8624,16562,2090135,2009939,4100074
"Barcelona 06A - Joanic","Demogràfic","Població assignada de 55-64 anys (n)",1598,1944,3542,485653,501618,987271
"Barcelona 06A - Joanic","Demogràfic","Població assignada de 65 anys o més (n)",2508,3900,6408,631736,839322,1471058
"Barcelona 06A - Joanic","Demogràfic","Població assignada total (n)",13776,16111,29887,3771014,3882239,7653253
"Barcelona 06B - Vila de Gràcia","Demogràfic","Població assignada de 0-14 anys (n)",856,800,1656,563490,531360,1094850
"Barcelona 06B - Vila de Gràcia","Demogràfic","Població assignada de 15-54 anys (n)",7801,8735,16536,2090135,2009939,4100074
"Barcelona 06B - Vila de Gràcia","Demogràfic","Població assignada de 55-64 anys (n)",1378,1598,2976,485653,501618,987271
"Barcelona 06B - Vila de Gràcia","Demogràfic","Població assignada de 65 anys o més (n)",1721,2802,4523,631736,839322,1471058
"Barcelona 06B - Vila de Gràcia","Demogràfic","Població assignada total (n)",11756,13935,25691,3771014,3882239,7653253
"Barcelona 06C - Lesseps","Demogràfic","Població assignada de 0-14 anys (n)",1275,1176,2451,563490,531360,1094850
"Barcelona 06C - Lesseps","Demogràfic","Població assignada de 15-54 anys (n)",5918,6459,12377,2090135,2009939,4100074
"Barcelona 06C - Lesseps","Demogràfic","Població assignada de 55-64 anys (n)",1200,1369,2569,485653,501618,987271
"Barcelona 06C - Lesseps","Demogràfic","Població assignada de 65 anys o més (n)",1868,3313,5181,631736,839322,1471058
"Barcelona 06C - Lesseps","Demogràfic","Població assignada total (n)",10261,12317,22578,3771014,3882239,7653253
"Barcelona 06D - Vallcarca","Demogràfic","Població assignada de 0-14 anys (n)",1660,1615,3275,563490,531360,1094850
"Barcelona 06D - Vallcarca","Demogràfic","Població assignada de 15-54 anys (n)",6110,6284,12394,2090135,2009939,4100074
"Barcelona 06D - Vallcarca","Demogràfic","Població assignada de 55-64 anys (n)",1335,1536,2871,485653,501618,987271
"Barcelona 06D - Vallcarca","Demogràfic","Població assignada de 65 anys o més (n)",1861,2780,4641,631736,839322,1471058
"Barcelona 06D - Vallcarca","Demogràfic","Població assignada total (n)",10966,12215,23181,3771014,3882239,7653253
"Barcelona 06E - La Salut","Demogràfic","Població assignada de 0-14 anys (n)",1225,1129,2354,563490,531360,1094850
"Barcelona 06E - La Salut","Demogràfic","Població assignada de 15-54 anys (n)",5410,5578,10988,2090135,2009939,4100074
"Barcelona 06E - La Salut","Demogràfic","Població assignada de 55-64 anys (n)",1140,1313,2453,485653,501618,987271
"Barcelona 06E - La Salut","Demogràfic","Població assignada de 65 anys o més (n)",2049,3321,5370,631736,839322,1471058
"Barcelona 06E - La Salut","Demogràfic","Població assignada total (n)",9824,11341,21165,3771014,3882239,7653253
"Barcelona 07A - Sanllehy","Demogràfic","Població assignada de 0-14 anys (n)",1256,1178,2434,563490,531360,1094850
"Barcelona 07A - Sanllehy","Demogràfic","Població assignada de 15-54 anys (n)",5582,5501,11083,2090135,2009939,4100074
"Barcelona 07A - Sanllehy","Demogràfic","Població assignada de 55-64 anys (n)",1336,1477,2813,485653,501618,987271
"Barcelona 07A - Sanllehy","Demogràfic","Població assignada de 65 anys o més (n)",1914,2951,4865,631736,839322,1471058
"Barcelona 07A - Sanllehy","Demogràfic","Població assignada total (n)",10088,11107,21195,3771014,3882239,7653253
"Barcelona 07B - Sardenya","Demogràfic","Població assignada de 0-14 anys (n)",1183,1111,2294,563490,531360,1094850
"Barcelona 07B - Sardenya","Demogràfic","Població assignada de 15-54 anys (n)",5087,5295,10382,2090135,2009939,4100074
"Barcelona 07B - Sardenya","Demogràfic","Població assignada de 55-64 anys (n)",1187,1393,2580,485653,501618,987271
"Barcelona 07B - Sardenya","Demogràfic","Població assignada de 65 anys o més (n)",1828,2890,4718,631736,839322,1471058
"Barcelona 07B - Sardenya","Demogràfic","Població assignada total (n)",9285,10689,19974,3771014,3882239,7653253
"Barcelona 07C - El Carmel","Demogràfic","Població assignada de 0-14 anys (n)",1305,1232,2537,563490,531360,1094850
"Barcelona 07C - El Carmel","Demogràfic","Població assignada de 15-54 anys (n)",5213,5115,10328,2090135,2009939,4100074
"Barcelona 07C - El Carmel","Demogràfic","Població assignada de 55-64 anys (n)",1160,1259,2419,485653,501618,987271
"Barcelona 07C - El Carmel","Demogràfic","Població assignada de 65 anys o més (n)",1672,2366,4038,631736,839322,1471058
"Barcelona 07C - El Carmel","Demogràfic","Població assignada total (n)",9350,9972,19322,3771014,3882239,7653253
"Barcelona 07D - Lisboa","Demogràfic","Població assignada de 0-14 anys (n)",1551,1522,3073,563490,531360,1094850
"Barcelona 07D - Lisboa","Demogràfic","Població assignada de 15-54 anys (n)",6807,6934,13741,2090135,2009939,4100074
"Barcelona 07D - Lisboa","Demogràfic","Població assignada de 55-64 anys (n)",1596,1846,3442,485653,501618,987271
"Barcelona 07D - Lisboa","Demogràfic","Població assignada de 65 anys o més (n)",2694,3971,6665,631736,839322,1471058
"Barcelona 07D - Lisboa","Demogràfic","Població assignada total (n)",12648,14273,26921,3771014,3882239,7653253
"Barcelona 07E - Sant Rafael","Demogràfic","Població assignada de 0-14 anys (n)",1802,1702,3504,563490,531360,1094850
"Barcelona 07E - Sant Rafael","Demogràfic","Població assignada de 15-54 anys (n)",7548,7615,15163,2090135,2009939,4100074
"Barcelona 07E - Sant Rafael","Demogràfic","Població assignada de 55-64 anys (n)",1933,2045,3978,485653,501618,987271
"Barcelona 07E - Sant Rafael","Demogràfic","Població assignada de 65 anys o més (n)",2760,4637,7397,631736,839322,1471058
"Barcelona 07E - Sant Rafael","Demogràfic","Població assignada total (n)",14043,15999,30042,3771014,3882239,7653253
"Barcelona 07F - Lisboa","Demogràfic","Població assignada de 0-14 anys (n)",1133,1033,2166,563490,531360,1094850
"Barcelona 07F - Lisboa","Demogràfic","Població assignada de 15-54 anys (n)",4638,4882,9520,2090135,2009939,4100074
"Barcelona 07F - Lisboa","Demogràfic","Població assignada de 55-64 anys (n)",1282,1398,2680,485653,501618,987271
"Barcelona 07F - Lisboa","Demogràfic","Població assignada de 65 anys o més (n)",2001,3177,5178,631736,839322,1471058
"Barcelona 07F - Lisboa","Demogràfic","Població assignada total (n)",9054,10490,19544,3771014,3882239,7653253
"Barcelona 07G - Guinardó","Demogràfic","Població assignada de 0-14 anys (n)",1487,1473,2960,563490,531360,1094850
"Barcelona 07G - Guinardó","Demogràfic","Població assignada de 15-54 anys (n)",8207,8778,16985,2090135,2009939,4100074
"Barcelona 07G - Guinardó","Demogràfic","Població assignada de 55-64 anys (n)",1797,2088,3885,485653,501618,987271
"Barcelona 07G - Guinardó","Demogràfic","Població assignada de 65 anys o més (n)",2813,4231,7044,631736,839322,1471058
"Barcelona 07G - Guinardó","Demogràfic","Població assignada total (n)",14304,16570,30874,3771014,3882239,7653253
"Barcelona 08C - Turó de la Peira","Demogràfic","Població assignada de 0-14 anys (n)",1416,1376,2792,563490,531360,1094850
"Barcelona 08C - Turó de la Peira","Demogràfic","Població assignada de 15-54 anys (n)",6042,6205,12247,2090135,2009939,4100074
"Barcelona 08C - Turó de la Peira","Demogràfic","Població assignada de 55-64 anys (n)",1541,1622,3163,485653,501618,987271
"Barcelona 08C - Turó de la Peira","Demogràfic","Població assignada de 65 anys o més (n)",1799,2966,4765,631736,839322,1471058
"Barcelona 08C - Turó de la Peira","Demogràfic","Població assignada total (n)",10798,12169,22967,3771014,3882239,7653253
"Barcelona 08F - Guineueta","Demogràfic","Població assignada de 0-14 anys (n)",1492,1388,2880,563490,531360,1094850
"Barcelona 08F - Guineueta","Demogràfic","Població assignada de 15-54 anys (n)",6001,5998,11999,2090135,2009939,4100074
"Barcelona 08F - Guineueta","Demogràfic","Població assignada de 55-64 anys (n)",1532,1746,3278,485653,501618,987271
"Barcelona 08F - Guineueta","Demogràfic","Població assignada de 65 anys o més (n)",2689,3914,6603,631736,839322,1471058
"Barcelona 08F - Guineueta","Demogràfic","Població assignada total (n)",11714,13046,24760,3771014,3882239,7653253
"Barcelona 08G - Roquetes","Demogràfic","Població assignada de 0-14 anys (n)",1271,1262,2533,563490,531360,1094850
"Barcelona 08G - Roquetes","Demogràfic","Població assignada de 15-54 anys (n)",4904,4970,9874,2090135,2009939,4100074
"Barcelona 08G - Roquetes","Demogràfic","Població assignada de 55-64 anys (n)",913,1083,1996,485653,501618,987271
"Barcelona 08G - Roquetes","Demogràfic","Població assignada de 65 anys o més (n)",1231,1659,2890,631736,839322,1471058
"Barcelona 08G - Roquetes","Demogràfic","Població assignada total (n)",8319,8974,17293,3771014,3882239,7653253
"Barcelona 08H - Ciutat Meridiana","Demogràfic","Població assignada de 0-14 anys (n)",1375,1307,2682,563490,531360,1094850
"Barcelona 08H - Ciutat Meridiana","Demogràfic","Població assignada de 15-54 anys (n)",4797,4584,9381,2090135,2009939,4100074
"Barcelona 08H - Ciutat Meridiana","Demogràfic","Població assignada de 55-64 anys (n)",940,983,1923,485653,501618,987271
"Barcelona 08H - Ciutat Meridiana","Demogràfic","Població assignada de 65 anys o més (n)",1072,1504,2576,631736,839322,1471058
"Barcelona 08H - Ciutat Meridiana","Demogràfic","Població assignada total (n)",8184,8378,16562,3771014,3882239,7653253
"Barcelona 08I - Xafarines","Demogràfic","Població assignada de 0-14 anys (n)",1273,1220,2493,563490,531360,1094850
"Barcelona 08I - Xafarines","Demogràfic","Població assignada de 15-54 anys (n)",4865,5017,9882,2090135,2009939,4100074
"Barcelona 08I - Xafarines","Demogràfic","Població assignada de 55-64 anys (n)",1143,1223,2366,485653,501618,987271
"Barcelona 08I - Xafarines","Demogràfic","Població assignada de 65 anys o més (n)",1400,2139,3539,631736,839322,1471058
"Barcelona 08I - Xafarines","Demogràfic","Població assignada total (n)",8681,9599,18280,3771014,3882239,7653253
"Barcelona 08J - Cotxeres","Demogràfic","Població assignada de 0-14 anys (n)",1656,1599,3255,563490,531360,1094850
"Barcelona 08J - Cotxeres","Demogràfic","Població assignada de 15-54 anys (n)",6776,7041,13817,2090135,2009939,4100074
"Barcelona 08J - Cotxeres","Demogràfic","Població assignada de 55-64 anys (n)",1581,1871,3452,485653,501618,987271
"Barcelona 08J - Cotxeres","Demogràfic","Població assignada de 65 anys o més (n)",2319,3754,6073,631736,839322,1471058
"Barcelona 08J - Cotxeres","Demogràfic","Població assignada total (n)",12332,14265,26597,3771014,3882239,7653253
"Barcelona 08K - Porta","Demogràfic","Població assignada de 0-14 anys (n)",1114,1175,2289,563490,531360,1094850
"Barcelona 08K - Porta","Demogràfic","Població assignada de 15-54 anys (n)",4031,4097,8128,2090135,2009939,4100074
"Barcelona 08K - Porta","Demogràfic","Població assignada de 55-64 anys (n)",927,1086,2013,485653,501618,987271
"Barcelona 08K - Porta","Demogràfic","Població assignada de 65 anys o més (n)",1701,2526,4227,631736,839322,1471058
"Barcelona 08K - Porta","Demogràfic","Població assignada total (n)",7773,8884,16657,3771014,3882239,7653253
"Barcelona 08L - Prosperitat - Verdum","Demogràfic","Població assignada de 0-14 anys (n)",1578,1511,3089,563490,531360,1094850
"Barcelona 08L - Prosperitat - Verdum","Demogràfic","Població assignada de 15-54 anys (n)",7488,7910,15398,2090135,2009939,4100074
"Barcelona 08L - Prosperitat - Verdum","Demogràfic","Població assignada de 55-64 anys (n)",1652,1863,3515,485653,501618,987271
"Barcelona 08L - Prosperitat - Verdum","Demogràfic","Població assignada de 65 anys o més (n)",2751,4018,6769,631736,839322,1471058
"Barcelona 08L - Prosperitat - Verdum","Demogràfic","Població assignada total (n)",13469,15302,28771,3771014,3882239,7653253
"Barcelona 09A - Sagrera","Demogràfic","Població assignada de 0-14 anys (n)",2175,1973,4148,563490,531360,1094850
"Barcelona 09A - Sagrera","Demogràfic","Població assignada de 15-54 anys (n)",9062,9383,18445,2090135,2009939,4100074
"Barcelona 09A - Sagrera","Demogràfic","Població assignada de 55-64 anys (n)",1996,2340,4336,485653,501618,987271
"Barcelona 09A - Sagrera","Demogràfic","Població assignada de 65 anys o més (n)",3393,4698,8091,631736,839322,1471058
"Barcelona 09A - Sagrera","Demogràfic","Població assignada total (n)",16626,18394,35020,3771014,3882239,7653253
"Barcelona 09C - Congrés","Demogràfic","Població assignada de 0-14 anys (n)",1677,1626,3303,563490,531360,1094850
"Barcelona 09C - Congrés","Demogràfic","Població assignada de 15-54 anys (n)",7517,7910,15427,2090135,2009939,4100074
"Barcelona 09C - Congrés","Demogràfic","Població assignada de 55-64 anys (n)",1950,2203,4153,485653,501618,987271
"Barcelona 09C - Congrés","Demogràfic","Població assignada de 65 anys o més (n)",2836,4318,7154,631736,839322,1471058
"Barcelona 09C - Congrés","Demogràfic","Població assignada total (n)",13980,16057,30037,3771014,3882239,7653253
"Barcelona 09E - Bon Pastor","Demogràfic","Població assignada de 0-14 anys (n)",1081,1014,2095,563490,531360,1094850
"Barcelona 09E - Bon Pastor","Demogràfic","Població assignada de 15-54 anys (n)",4063,3820,7883,2090135,2009939,4100074
"Barcelona 09E - Bon Pastor","Demogràfic","Població assignada de 55-64 anys (n)",879,917,1796,485653,501618,987271
"Barcelona 09E - Bon Pastor","Demogràfic","Població assignada de 65 anys o més (n)",1018,1491,2509,631736,839322,1471058
"Barcelona 09E - Bon Pastor","Demogràfic","Població assignada total (n)",7041,7242,14283,3771014,3882239,7653253
"Barcelona 09F - Via Barcino","Demogràfic","Població assignada de 0-14 anys (n)",994,891,1885,563490,531360,1094850
"Barcelona 09F - Via Barcino","Demogràfic","Població assignada de 15-54 anys (n)",3463,2916,6379,2090135,2009939,4100074
"Barcelona 09F - Via Barcino","Demogràfic","Població assignada de 55-64 anys (n)",641,599,1240,485653,501618,987271
"Barcelona 09F - Via Barcino","Demogràfic","Població assignada de 65 anys o més (n)",661,896,1557,631736,839322,1471058
"Barcelona 09F - Via Barcino","Demogràfic","Població assignada total (n)",5759,5302,11061,3771014,3882239,7653253
"Barcelona 09H - Cap Sant Andreu","Demogràfic","Població assignada de 0-14 anys (n)",1411,1338,2749,563490,531360,1094850
"Barcelona 09H - Cap Sant Andreu","Demogràfic","Població assignada de 15-54 anys (n)",7697,7706,15403,2090135,2009939,4100074
"Barcelona 09H - Cap Sant Andreu","Demogràfic","Població assignada de 55-64 anys (n)",1968,2414,4382,485653,501618,987271
"Barcelona 09H - Cap Sant Andreu","Demogràfic","Població assignada de 65 anys o més (n)",3276,4484,7760,631736,839322,1471058
"Barcelona 09H - Cap Sant Andreu","Demogràfic","Població assignada total (n)",14352,15942,30294,3771014,3882239,7653253
"Barcelona 09I - Cap Casernes","Demogràfic","Població assignada de 0-14 anys (n)",2258,2134,4392,563490,531360,1094850
"Barcelona 09I - Cap Casernes","Demogràfic","Població assignada de 15-54 anys (n)",6582,6811,13393,2090135,2009939,4100074
"Barcelona 09I - Cap Casernes","Demogràfic","Població assignada de 55-64 anys (n)",1507,1632,3139,485653,501618,987271
"Barcelona 09I - Cap Casernes","Demogràfic","Població assignada de 65 anys o més (n)",2157,3020,5177,631736,839322,1471058
"Barcelona 09I - Cap Casernes","Demogràfic","Població assignada total (n)",12504,13597,26101,3771014,3882239,7653253
"Barcelona 10A - Vila Olímpica","Demogràfic","Població assignada de 0-14 anys (n)",2082,1902,3984,563490,531360,1094850
"Barcelona 10A - Vila Olímpica","Demogràfic","Població assignada de 15-54 anys (n)",8861,8869,17730,2090135,2009939,4100074
"Barcelona 10A - Vila Olímpica","Demogràfic","Població assignada de 55-64 anys (n)",2151,2267,4418,485653,501618,987271
"Barcelona 10A - Vila Olímpica","Demogràfic","Població assignada de 65 anys o més (n)",2420,3231,5651,631736,839322,1471058
"Barcelona 10A - Vila Olímpica","Demogràfic","Població assignada total (n)",15514,16269,31783,3771014,3882239,7653253
"Barcelona 10B - Ramon Turró","Demogràfic","Població assignada de 0-14 anys (n)",2484,2298,4782,563490,531360,1094850
"Barcelona 10B - Ramon Turró","Demogràfic","Població assignada de 15-54 anys (n)",8547,8686,17233,2090135,2009939,4100074
"Barcelona 10B - Ramon Turró","Demogràfic","Població assignada de 55-64 anys (n)",1855,1861,3716,485653,501618,987271
"Barcelona 10B - Ramon Turró","Demogràfic","Població assignada de 65 anys o més (n)",2010,2748,4758,631736,839322,1471058
"Barcelona 10B - Ramon Turró","Demogràfic","Població assignada total (n)",14896,15593,30489,3771014,3882239,7653253
"Barcelona 10C - Poble Nou","Demogràfic","Població assignada de 0-14 anys (n)",2063,1908,3971,563490,531360,1094850
"Barcelona 10C - Poble Nou","Demogràfic","Població assignada de 15-54 anys (n)",7306,7467,14773,2090135,2009939,4100074
"Barcelona 10C - Poble Nou","Demogràfic","Població assignada de 55-64 anys (n)",1499,1608,3107,485653,501618,987271
"Barcelona 10C - Poble Nou","Demogràfic","Població assignada de 65 anys o més (n)",1708,2428,4136,631736,839322,1471058
"Barcelona 10C - Poble Nou","Demogràfic","Població assignada total (n)",12576,13411,25987,3771014,3882239,7653253
"Barcelona 10D - Besòs","Demogràfic","Població assignada de 0-14 anys (n)",1809,1674,3483,563490,531360,1094850
"Barcelona 10D - Besòs","Demogràfic","Població assignada de 15-54 anys (n)",8236,6368,14604,2090135,2009939,4100074
"Barcelona 10D - Besòs","Demogràfic","Població assignada de 55-64 anys (n)",1640,1737,3377,485653,501618,987271
"Barcelona 10D - Besòs","Demogràfic","Població assignada de 65 anys o més (n)",1972,2724,4696,631736,839322,1471058
"Barcelona 10D - Besòs","Demogràfic","Població assignada total (n)",13657,12503,26160,3771014,3882239,7653253
"Barcelona 10E - Encants","Demogràfic","Població assignada de 0-14 anys (n)",988,922,1910,563490,531360,1094850
"Barcelona 10E - Encants","Demogràfic","Població assignada de 15-54 anys (n)",4355,4313,8668,2090135,2009939,4100074
"Barcelona 10E - Encants","Demogràfic","Població assignada de 55-64 anys (n)",1010,1185,2195,485653,501618,987271
"Barcelona 10E - Encants","Demogràfic","Població assignada de 65 anys o més (n)",1571,2358,3929,631736,839322,1471058
"Barcelona 10E - Encants","Demogràfic","Població assignada total (n)",7924,8778,16702,3771014,3882239,7653253
"Barcelona 10F - Camp de l'Arpa","Demogràfic","Població assignada de 0-14 anys (n)",1505,1415,2920,563490,531360,1094850
"Barcelona 10F - Camp de l'Arpa","Demogràfic","Població assignada de 15-54 anys (n)",6199,6557,12756,2090135,2009939,4100074
"Barcelona 10F - Camp de l'Arpa","Demogràfic","Població assignada de 55-64 anys (n)",1360,1600,2960,485653,501618,987271
"Barcelona 10F - Camp de l'Arpa","Demogràfic","Població assignada de 65 anys o més (n)",2164,3174,5338,631736,839322,1471058
"Barcelona 10F - Camp de l'Arpa","Demogràfic","Població assignada total (n)",11228,12746,23974,3771014,3882239,7653253
"Barcelona 10G - El Clot","Demogràfic","Població assignada de 0-14 anys (n)",1999,1816,3815,563490,531360,1094850
"Barcelona 10G - El Clot","Demogràfic","Població assignada de 15-54 anys (n)",7327,7210,14537,2090135,2009939,4100074
"Barcelona 10G - El Clot","Demogràfic","Població assignada de 55-64 anys (n)",1623,1917,3540,485653,501618,987271
"Barcelona 10G - El Clot","Demogràfic","Població assignada de 65 anys o més (n)",2138,2977,5115,631736,839322,1471058
"Barcelona 10G - El Clot","Demogràfic","Població assignada total (n)",13087,13920,27007,3771014,3882239,7653253
"Barcelona 10H - Sant Martí","Demogràfic","Població assignada de 0-14 anys (n)",625,636,1261,563490,531360,1094850
"Barcelona 10H - Sant Martí","Demogràfic","Població assignada de 15-54 anys (n)",4675,4744,9419,2090135,2009939,4100074
"Barcelona 10H - Sant Martí","Demogràfic","Població assignada de 55-64 anys (n)",1136,1265,2401,485653,501618,987271
"Barcelona 10H - Sant Martí","Demogràfic","Població assignada de 65 anys o més (n)",2039,3002,5041,631736,839322,1471058
"Barcelona 10H - Sant Martí","Demogràfic","Població assignada total (n)",8475,9647,18122,3771014,3882239,7653253
"Barcelona 10I - La Pau","Demogràfic","Població assignada de 0-14 anys (n)",852,782,1634,563490,531360,1094850
"Barcelona 10I - La Pau","Demogràfic","Població assignada de 15-54 anys (n)",3664,3621,7285,2090135,2009939,4100074
"Barcelona 10I - La Pau","Demogràfic","Població assignada de 55-64 anys (n)",857,931,1788,485653,501618,987271
"Barcelona 10I - La Pau","Demogràfic","Població assignada de 65 anys o més (n)",1195,1849,3044,631736,839322,1471058
"Barcelona 10I - La Pau","Demogràfic","Població assignada total (n)",6568,7183,13751,3771014,3882239,7653253
"Barcelona 10J - Verneda Sud","Demogràfic","Població assignada de 0-14 anys (n)",1254,1197,2451,563490,531360,1094850
"Barcelona 10J - Verneda Sud","Demogràfic","Població assignada de 15-54 anys (n)",5659,5660,11319,2090135,2009939,4100074
"Barcelona 10J - Verneda Sud","Demogràfic","Població assignada de 55-64 anys (n)",1481,1689,3170,485653,501618,987271
"Barcelona 10J - Verneda Sud","Demogràfic","Població assignada de 65 anys o més (n)",2213,3208,5421,631736,839322,1471058
"Barcelona 10J - Verneda Sud","Demogràfic","Població assignada total (n)",10607,11754,22361,3771014,3882239,7653253
"Bàscara","Demogràfic","Població assignada de 0-14 anys (n)",310,294,604,563490,531360,1094850
"Bàscara","Demogràfic","Població assignada de 15-54 anys (n)",1150,1020,2170,2090135,2009939,4100074
"Bàscara","Demogràfic","Població assignada de 55-64 anys (n)",370,311,681,485653,501618,987271
"Bàscara","Demogràfic","Població assignada de 65 anys o més (n)",488,540,1028,631736,839322,1471058
"Bàscara","Demogràfic","Població assignada total (n)",2318,2165,4483,3771014,3882239,7653253
"Begues - Pou Torre","Demogràfic","Població assignada de 0-14 anys (n)",615,596,1211,563490,531360,1094850
"Begues - Pou Torre","Demogràfic","Població assignada de 15-54 anys (n)",1977,1920,3897,2090135,2009939,4100074
"Begues - Pou Torre","Demogràfic","Població assignada de 55-64 anys (n)",499,489,988,485653,501618,987271
"Begues - Pou Torre","Demogràfic","Població assignada de 65 anys o més (n)",464,535,999,631736,839322,1471058
"Begues - Pou Torre","Demogràfic","Població assignada total (n)",3555,3540,7095,3771014,3882239,7653253
"Bellpuig","Demogràfic","Població assignada de 0-14 anys (n)",470,494,964,563490,531360,1094850
"Bellpuig","Demogràfic","Població assignada de 15-54 anys (n)",2023,1593,3616,2090135,2009939,4100074
"Bellpuig","Demogràfic","Població assignada de 55-64 anys (n)",541,421,962,485653,501618,987271
"Bellpuig","Demogràfic","Població assignada de 65 anys o més (n)",731,915,1646,631736,839322,1471058
"Bellpuig","Demogràfic","Població assignada total (n)",3765,3423,7188,3771014,3882239,7653253
"Berga Centre","Demogràfic","Població assignada de 0-14 anys (n)",1480,1291,2771,563490,531360,1094850
"Berga Centre","Demogràfic","Població assignada de 15-54 anys (n)",5334,4898,10232,2090135,2009939,4100074
"Berga Centre","Demogràfic","Població assignada de 55-64 anys (n)",1597,1552,3149,485653,501618,987271
"Berga Centre","Demogràfic","Població assignada de 65 anys o més (n)",2149,2750,4899,631736,839322,1471058
"Berga Centre","Demogràfic","Població assignada total (n)",10560,10491,21051,3771014,3882239,7653253
"Besalú","Demogràfic","Població assignada de 0-14 anys (n)",427,430,857,563490,531360,1094850
"Besalú","Demogràfic","Població assignada de 15-54 anys (n)",1452,1431,2883,2090135,2009939,4100074
"Besalú","Demogràfic","Població assignada de 55-64 anys (n)",459,394,853,485653,501618,987271
"Besalú","Demogràfic","Població assignada de 65 anys o més (n)",620,724,1344,631736,839322,1471058
"Besalú","Demogràfic","Població assignada total (n)",2958,2979,5937,3771014,3882239,7653253
"Blanes","Demogràfic","Població assignada de 0-14 anys (n)",2726,2544,5270,563490,531360,1094850
"Blanes","Demogràfic","Població assignada de 15-54 anys (n)",11048,10355,21403,2090135,2009939,4100074
"Blanes","Demogràfic","Població assignada de 55-64 anys (n)",2749,2826,5575,485653,501618,987271
"Blanes","Demogràfic","Població assignada de 65 anys o més (n)",3373,4338,7711,631736,839322,1471058
"Blanes","Demogràfic","Població assignada total (n)",19896,20063,39959,3771014,3882239,7653253
"Breda - Hostalric","Demogràfic","Població assignada de 0-14 anys (n)",950,904,1854,563490,531360,1094850
"Breda - Hostalric","Demogràfic","Població assignada de 15-54 anys (n)",3561,3252,6813,2090135,2009939,4100074
"Breda - Hostalric","Demogràfic","Població assignada de 55-64 anys (n)",875,835,1710,485653,501618,987271
"Breda - Hostalric","Demogràfic","Població assignada de 65 anys o més (n)",1110,1278,2388,631736,839322,1471058
"Breda - Hostalric","Demogràfic","Població assignada total (n)",6496,6269,12765,3771014,3882239,7653253
"Calaf","Demogràfic","Població assignada de 0-14 anys (n)",569,482,1051,563490,531360,1094850
"Calaf","Demogràfic","Població assignada de 15-54 anys (n)",1738,1463,3201,2090135,2009939,4100074
"Calaf","Demogràfic","Població assignada de 55-64 anys (n)",505,474,979,485653,501618,987271
"Calaf","Demogràfic","Població assignada de 65 anys o més (n)",703,809,1512,631736,839322,1471058
"Calaf","Demogràfic","Població assignada total (n)",3515,3228,6743,3771014,3882239,7653253
"Calafell","Demogràfic","Població assignada de 0-14 anys (n)",2162,2006,4168,563490,531360,1094850
"Calafell","Demogràfic","Població assignada de 15-54 anys (n)",7140,6958,14098,2090135,2009939,4100074
"Calafell","Demogràfic","Població assignada de 55-64 anys (n)",1673,1763,3436,485653,501618,987271
"Calafell","Demogràfic","Població assignada de 65 anys o més (n)",2503,3095,5598,631736,839322,1471058
"Calafell","Demogràfic","Població assignada total (n)",13478,13822,27300,3771014,3882239,7653253
"Caldes de Montbui","Demogràfic","Població assignada de 0-14 anys (n)",1799,1669,3468,563490,531360,1094850
"Caldes de Montbui","Demogràfic","Població assignada de 15-54 anys (n)",6806,6304,13110,2090135,2009939,4100074
"Caldes de Montbui","Demogràfic","Població assignada de 55-64 anys (n)",1660,1629,3289,485653,501618,987271
"Caldes de Montbui","Demogràfic","Població assignada de 65 anys o més (n)",1927,2530,4457,631736,839322,1471058
"Caldes de Montbui","Demogràfic","Població assignada total (n)",12192,12132,24324,3771014,3882239,7653253
"Calella","Demogràfic","Població assignada de 0-14 anys (n)",1339,1275,2614,563490,531360,1094850
"Calella","Demogràfic","Població assignada de 15-54 anys (n)",5093,4983,10076,2090135,2009939,4100074
"Calella","Demogràfic","Població assignada de 55-64 anys (n)",1328,1400,2728,485653,501618,987271
"Calella","Demogràfic","Població assignada de 65 anys o més (n)",1723,2455,4178,631736,839322,1471058
"Calella","Demogràfic","Població assignada total (n)",9483,10113,19596,3771014,3882239,7653253
"Cambrils","Demogràfic","Població assignada de 0-14 anys (n)",2862,2670,5532,563490,531360,1094850
"Cambrils","Demogràfic","Població assignada de 15-54 anys (n)",9187,9437,18624,2090135,2009939,4100074
"Cambrils","Demogràfic","Població assignada de 55-64 anys (n)",2104,2129,4233,485653,501618,987271
"Cambrils","Demogràfic","Població assignada de 65 anys o més (n)",2602,3284,5886,631736,839322,1471058
"Cambrils","Demogràfic","Població assignada total (n)",16755,17520,34275,3771014,3882239,7653253
"Camprodon","Demogràfic","Població assignada de 0-14 anys (n)",257,264,521,563490,531360,1094850
"Camprodon","Demogràfic","Població assignada de 15-54 anys (n)",938,936,1874,2090135,2009939,4100074
"Camprodon","Demogràfic","Població assignada de 55-64 anys (n)",310,298,608,485653,501618,987271
"Camprodon","Demogràfic","Població assignada de 65 anys o més (n)",523,602,1125,631736,839322,1471058
"Camprodon","Demogràfic","Població assignada total (n)",2028,2100,4128,3771014,3882239,7653253
"Canet de Mar","Demogràfic","Població assignada de 0-14 anys (n)",1660,1580,3240,563490,531360,1094850
"Canet de Mar","Demogràfic","Població assignada de 15-54 anys (n)",5990,5768,11758,2090135,2009939,4100074
"Canet de Mar","Demogràfic","Població assignada de 55-64 anys (n)",1564,1527,3091,485653,501618,987271
"Canet de Mar","Demogràfic","Població assignada de 65 anys o més (n)",2176,2795,4971,631736,839322,1471058
"Canet de Mar","Demogràfic","Població assignada total (n)",11390,11670,23060,3771014,3882239,7653253
"Capellades","Demogràfic","Població assignada de 0-14 anys (n)",806,753,1559,563490,531360,1094850
"Capellades","Demogràfic","Població assignada de 15-54 anys (n)",2891,2667,5558,2090135,2009939,4100074
"Capellades","Demogràfic","Població assignada de 55-64 anys (n)",755,702,1457,485653,501618,987271
"Capellades","Demogràfic","Població assignada de 65 anys o més (n)",973,1192,2165,631736,839322,1471058
"Capellades","Demogràfic","Població assignada total (n)",5425,5314,10739,3771014,3882239,7653253
"Cardedeu","Demogràfic","Població assignada de 0-14 anys (n)",1898,1826,3724,563490,531360,1094850
"Cardedeu","Demogràfic","Població assignada de 15-54 anys (n)",6100,6020,12120,2090135,2009939,4100074
"Cardedeu","Demogràfic","Població assignada de 55-64 anys (n)",1372,1441,2813,485653,501618,987271
"Cardedeu","Demogràfic","Població assignada de 65 anys o més (n)",1729,2172,3901,631736,839322,1471058
"Cardedeu","Demogràfic","Població assignada total (n)",11099,11459,22558,3771014,3882239,7653253
"Cardona","Demogràfic","Població assignada de 0-14 anys (n)",335,327,662,563490,531360,1094850
"Cardona","Demogràfic","Població assignada de 15-54 anys (n)",1119,1048,2167,2090135,2009939,4100074
"Cardona","Demogràfic","Població assignada de 55-64 anys (n)",386,378,764,485653,501618,987271
"Cardona","Demogràfic","Població assignada de 65 anys o més (n)",610,780,1390,631736,839322,1471058
"Cardona","Demogràfic","Població assignada total (n)",2450,2533,4983,3771014,3882239,7653253
"Cassà de la Selva","Demogràfic","Població assignada de 0-14 anys (n)",2725,2650,5375,563490,531360,1094850
"Cassà de la Selva","Demogràfic","Població assignada de 15-54 anys (n)",9068,8329,17397,2090135,2009939,4100074
"Cassà de la Selva","Demogràfic","Població assignada de 55-64 anys (n)",2111,2028,4139,485653,501618,987271
"Cassà de la Selva","Demogràfic","Població assignada de 65 anys o més (n)",2540,3088,5628,631736,839322,1471058
"Cassà de la Selva","Demogràfic","Població assignada total (n)",16444,16095,32539,3771014,3882239,7653253
"Castellar del Vallès","Demogràfic","Població assignada de 0-14 anys (n)",2066,1844,3910,563490,531360,1094850
"Castellar del Vallès","Demogràfic","Població assignada de 15-54 anys (n)",7043,6902,13945,2090135,2009939,4100074
"Castellar del Vallès","Demogràfic","Població assignada de 55-64 anys (n)",1768,1848,3616,485653,501618,987271
"Castellar del Vallès","Demogràfic","Població assignada de 65 anys o més (n)",2128,2677,4805,631736,839322,1471058
"Castellar del Vallès","Demogràfic","Població assignada total (n)",13005,13271,26276,3771014,3882239,7653253
"Castellbisbal","Demogràfic","Població assignada de 0-14 anys (n)",942,888,1830,563490,531360,1094850
"Castellbisbal","Demogràfic","Població assignada de 15-54 anys (n)",3165,3025,6190,2090135,2009939,4100074
"Castellbisbal","Demogràfic","Població assignada de 55-64 anys (n)",758,727,1485,485653,501618,987271
"Castellbisbal","Demogràfic","Població assignada de 65 anys o més (n)",678,777,1455,631736,839322,1471058
"Castellbisbal","Demogràfic","Població assignada total (n)",5543,5417,10960,3771014,3882239,7653253
"Castelldefels 01 - El Castell","Demogràfic","Població assignada de 0-14 anys (n)",2388,2265,4653,563490,531360,1094850
"Castelldefels 01 - El Castell","Demogràfic","Població assignada de 15-54 anys (n)",9421,9304,18725,2090135,2009939,4100074
"Castelldefels 01 - El Castell","Demogràfic","Població assignada de 55-64 anys (n)",2124,2309,4433,485653,501618,987271
"Castelldefels 01 - El Castell","Demogràfic","Població assignada de 65 anys o més (n)",2309,3289,5598,631736,839322,1471058
"Castelldefels 01 - El Castell","Demogràfic","Població assignada total (n)",16242,17167,33409,3771014,3882239,7653253
"Castelldefels 02 - Can Bou","Demogràfic","Població assignada de 0-14 anys (n)",2991,2757,5748,563490,531360,1094850
"Castelldefels 02 - Can Bou","Demogràfic","Població assignada de 15-54 anys (n)",9471,9883,19354,2090135,2009939,4100074
"Castelldefels 02 - Can Bou","Demogràfic","Població assignada de 55-64 anys (n)",2179,2041,4220,485653,501618,987271
"Castelldefels 02 - Can Bou","Demogràfic","Població assignada de 65 anys o més (n)",2127,2766,4893,631736,839322,1471058
"Castelldefels 02 - Can Bou","Demogràfic","Població assignada total (n)",16768,17447,34215,3771014,3882239,7653253
"Celrà","Demogràfic","Població assignada de 0-14 anys (n)",899,877,1776,563490,531360,1094850
"Celrà","Demogràfic","Població assignada de 15-54 anys (n)",2863,2658,5521,2090135,2009939,4100074
"Celrà","Demogràfic","Població assignada de 55-64 anys (n)",617,594,1211,485653,501618,987271
"Celrà","Demogràfic","Població assignada de 65 anys o més (n)",660,795,1455,631736,839322,1471058
"Celrà","Demogràfic","Població assignada total (n)",5039,4924,9963,3771014,3882239,7653253
"Centelles","Demogràfic","Població assignada de 0-14 anys (n)",1038,974,2012,563490,531360,1094850
"Centelles","Demogràfic","Població assignada de 15-54 anys (n)",3702,3526,7228,2090135,2009939,4100074
"Centelles","Demogràfic","Població assignada de 55-64 anys (n)",936,917,1853,485653,501618,987271
"Centelles","Demogràfic","Població assignada de 65 anys o més (n)",1076,1419,2495,631736,839322,1471058
"Centelles","Demogràfic","Població assignada total (n)",6752,6836,13588,3771014,3882239,7653253
"Cerdanya","Demogràfic","Població assignada de 0-14 anys (n)",1196,1169,2365,563490,531360,1094850
"Cerdanya","Demogràfic","Població assignada de 15-54 anys (n)",4940,4620,9560,2090135,2009939,4100074
"Cerdanya","Demogràfic","Població assignada de 55-64 anys (n)",1201,1087,2288,485653,501618,987271
"Cerdanya","Demogràfic","Població assignada de 65 anys o més (n)",1373,1583,2956,631736,839322,1471058
"Cerdanya","Demogràfic","Població assignada total (n)",8710,8459,17169,3771014,3882239,7653253
"Cerdanyola - Ripollet - La Farigola","Demogràfic","Població assignada de 0-14 anys (n)",30,21,51,563490,531360,1094850
"Cerdanyola - Ripollet - La Farigola","Demogràfic","Població assignada de 15-54 anys (n)",3362,3233,6595,2090135,2009939,4100074
"Cerdanyola - Ripollet - La Farigola","Demogràfic","Població assignada de 55-64 anys (n)",665,675,1340,485653,501618,987271
"Cerdanyola - Ripollet - La Farigola","Demogràfic","Població assignada de 65 anys o més (n)",868,1130,1998,631736,839322,1471058
"Cerdanyola - Ripollet - La Farigola","Demogràfic","Població assignada total (n)",4925,5059,9984,3771014,3882239,7653253
"Cerdanyola del Vallès 01 - Serraparera","Demogràfic","Població assignada de 0-14 anys (n)",1693,1571,3264,563490,531360,1094850
"Cerdanyola del Vallès 01 - Serraparera","Demogràfic","Població assignada de 15-54 anys (n)",6467,6132,12599,2090135,2009939,4100074
"Cerdanyola del Vallès 01 - Serraparera","Demogràfic","Població assignada de 55-64 anys (n)",1621,1806,3427,485653,501618,987271
"Cerdanyola del Vallès 01 - Serraparera","Demogràfic","Població assignada de 65 anys o més (n)",2290,2882,5172,631736,839322,1471058
"Cerdanyola del Vallès 01 - Serraparera","Demogràfic","Població assignada total (n)",12071,12391,24462,3771014,3882239,7653253
"Cerdanyola del Vallès 02 - Canaletes - Fontetes","Demogràfic","Població assignada de 0-14 anys (n)",2113,1929,4042,563490,531360,1094850
"Cerdanyola del Vallès 02 - Canaletes - Fontetes","Demogràfic","Població assignada de 15-54 anys (n)",6582,6548,13130,2090135,2009939,4100074
"Cerdanyola del Vallès 02 - Canaletes - Fontetes","Demogràfic","Població assignada de 55-64 anys (n)",1714,1742,3456,485653,501618,987271
"Cerdanyola del Vallès 02 - Canaletes - Fontetes","Demogràfic","Població assignada de 65 anys o més (n)",2195,2832,5027,631736,839322,1471058
"Cerdanyola del Vallès 02 - Canaletes - Fontetes","Demogràfic","Població assignada total (n)",12604,13051,25655,3771014,3882239,7653253
"Cervera","Demogràfic","Població assignada de 0-14 anys (n)",1696,1590,3286,563490,531360,1094850
"Cervera","Demogràfic","Població assignada de 15-54 anys (n)",6237,5137,11374,2090135,2009939,4100074
"Cervera","Demogràfic","Població assignada de 55-64 anys (n)",1435,1137,2572,485653,501618,987271
"Cervera","Demogràfic","Població assignada de 65 anys o més (n)",1589,1958,3547,631736,839322,1471058
"Cervera","Demogràfic","Població assignada total (n)",10957,9822,20779,3771014,3882239,7653253
"Constantí","Demogràfic","Població assignada de 0-14 anys (n)",688,657,1345,563490,531360,1094850
"Constantí","Demogràfic","Població assignada de 15-54 anys (n)",1979,1849,3828,2090135,2009939,4100074
"Constantí","Demogràfic","Població assignada de 55-64 anys (n)",415,361,776,485653,501618,987271
"Constantí","Demogràfic","Població assignada de 65 anys o més (n)",447,522,969,631736,839322,1471058
"Constantí","Demogràfic","Població assignada total (n)",3529,3389,6918,3771014,3882239,7653253
"Corbera de Llobregat","Demogràfic","Població assignada de 0-14 anys (n)",1363,1301,2664,563490,531360,1094850
"Corbera de Llobregat","Demogràfic","Població assignada de 15-54 anys (n)",4797,4703,9500,2090135,2009939,4100074
"Corbera de Llobregat","Demogràfic","Població assignada de 55-64 anys (n)",1300,1211,2511,485653,501618,987271
"Corbera de Llobregat","Demogràfic","Població assignada de 65 anys o més (n)",1299,1605,2904,631736,839322,1471058
"Corbera de Llobregat","Demogràfic","Població assignada total (n)",8759,8820,17579,3771014,3882239,7653253
"Cornellà de Llobregat 01 - Martí Julià","Demogràfic","Població assignada de 0-14 anys (n)",2187,2059,4246,563490,531360,1094850
"Cornellà de Llobregat 01 - Martí Julià","Demogràfic","Població assignada de 15-54 anys (n)",8193,8100,16293,2090135,2009939,4100074
"Cornellà de Llobregat 01 - Martí Julià","Demogràfic","Població assignada de 55-64 anys (n)",2034,2026,4060,485653,501618,987271
"Cornellà de Llobregat 01 - Martí Julià","Demogràfic","Població assignada de 65 anys o més (n)",2285,3150,5435,631736,839322,1471058
"Cornellà de Llobregat 01 - Martí Julià","Demogràfic","Població assignada total (n)",14699,15335,30034,3771014,3882239,7653253
"Cornellà de Llobregat 02 - Sant Ildefons","Demogràfic","Població assignada de 0-14 anys (n)",2040,1979,4019,563490,531360,1094850
"Cornellà de Llobregat 02 - Sant Ildefons","Demogràfic","Població assignada de 15-54 anys (n)",7785,7307,15092,2090135,2009939,4100074
"Cornellà de Llobregat 02 - Sant Ildefons","Demogràfic","Població assignada de 55-64 anys (n)",1632,1707,3339,485653,501618,987271
"Cornellà de Llobregat 02 - Sant Ildefons","Demogràfic","Població assignada de 65 anys o més (n)",2220,3137,5357,631736,839322,1471058
"Cornellà de Llobregat 02 - Sant Ildefons","Demogràfic","Població assignada total (n)",13677,14130,27807,3771014,3882239,7653253
"Cornellà de Llobregat 03 - Gavarra","Demogràfic","Població assignada de 0-14 anys (n)",844,856,1700,563490,531360,1094850
"Cornellà de Llobregat 03 - Gavarra","Demogràfic","Població assignada de 15-54 anys (n)",3416,3403,6819,2090135,2009939,4100074
"Cornellà de Llobregat 03 - Gavarra","Demogràfic","Població assignada de 55-64 anys (n)",740,844,1584,485653,501618,987271
"Cornellà de Llobregat 03 - Gavarra","Demogràfic","Població assignada de 65 anys o més (n)",1531,2121,3652,631736,839322,1471058
"Cornellà de Llobregat 03 - Gavarra","Demogràfic","Població assignada total (n)",6531,7224,13755,3771014,3882239,7653253
"Cornellà de Llobregat 04 - Jaume Soler","Demogràfic","Població assignada de 0-14 anys (n)",1138,1108,2246,563490,531360,1094850
"Cornellà de Llobregat 04 - Jaume Soler","Demogràfic","Població assignada de 15-54 anys (n)",4396,4398,8794,2090135,2009939,4100074
"Cornellà de Llobregat 04 - Jaume Soler","Demogràfic","Població assignada de 55-64 anys (n)",1049,1121,2170,485653,501618,987271
"Cornellà de Llobregat 04 - Jaume Soler","Demogràfic","Població assignada de 65 anys o més (n)",1369,1967,3336,631736,839322,1471058
"Cornellà de Llobregat 04 - Jaume Soler","Demogràfic","Població assignada total (n)",7952,8594,16546,3771014,3882239,7653253
"Cornudella de Montsant","Demogràfic","Població assignada de 0-14 anys (n)",131,119,250,563490,531360,1094850
"Cornudella de Montsant","Demogràfic","Població assignada de 15-54 anys (n)",611,483,1094,2090135,2009939,4100074
"Cornudella de Montsant","Demogràfic","Població assignada de 55-64 anys (n)",177,140,317,485653,501618,987271
"Cornudella de Montsant","Demogràfic","Població assignada de 65 anys o més (n)",282,309,591,631736,839322,1471058
"Cornudella de Montsant","Demogràfic","Població assignada total (n)",1201,1051,2252,3771014,3882239,7653253
"Cubelles - Cunit","Demogràfic","Població assignada de 0-14 anys (n)",2462,2357,4819,563490,531360,1094850
"Cubelles - Cunit","Demogràfic","Població assignada de 15-54 anys (n)",7801,7653,15454,2090135,2009939,4100074
"Cubelles - Cunit","Demogràfic","Població assignada de 55-64 anys (n)",1705,1771,3476,485653,501618,987271
"Cubelles - Cunit","Demogràfic","Població assignada de 65 anys o més (n)",2591,3163,5754,631736,839322,1471058
"Cubelles - Cunit","Demogràfic","Població assignada total (n)",14559,14944,29503,3771014,3882239,7653253
"Deltebre","Demogràfic","Població assignada de 0-14 anys (n)",988,985,1973,563490,531360,1094850
"Deltebre","Demogràfic","Població assignada de 15-54 anys (n)",3900,3533,7433,2090135,2009939,4100074
"Deltebre","Demogràfic","Població assignada de 55-64 anys (n)",1038,1021,2059,485653,501618,987271
"Deltebre","Demogràfic","Població assignada de 65 anys o més (n)",1594,1886,3480,631736,839322,1471058
"Deltebre","Demogràfic","Població assignada total (n)",7520,7425,14945,3771014,3882239,7653253
"El Masnou - Alella","Demogràfic","Població assignada de 0-14 anys (n)",2852,2597,5449,563490,531360,1094850
"El Masnou - Alella","Demogràfic","Població assignada de 15-54 anys (n)",6114,6188,12302,2090135,2009939,4100074
"El Masnou - Alella","Demogràfic","Població assignada de 55-64 anys (n)",1568,1738,3306,485653,501618,987271
"El Masnou - Alella","Demogràfic","Població assignada de 65 anys o més (n)",2293,2940,5233,631736,839322,1471058
"El Masnou - Alella","Demogràfic","Població assignada total (n)",12827,13463,26290,3771014,3882239,7653253
"El Morell","Demogràfic","Població assignada de 0-14 anys (n)",1122,1002,2124,563490,531360,1094850
"El Morell","Demogràfic","Població assignada de 15-54 anys (n)",3301,3030,6331,2090135,2009939,4100074
"El Morell","Demogràfic","Població assignada de 55-64 anys (n)",677,615,1292,485653,501618,987271
"El Morell","Demogràfic","Població assignada de 65 anys o més (n)",717,888,1605,631736,839322,1471058
"El Morell","Demogràfic","Població assignada total (n)",5817,5535,11352,3771014,3882239,7653253
"El Prat de Llobregat 01 - Ramona Via","Demogràfic","Població assignada de 0-14 anys (n)",1649,1594,3243,563490,531360,1094850
"El Prat de Llobregat 01 - Ramona Via","Demogràfic","Població assignada de 15-54 anys (n)",5985,5762,11747,2090135,2009939,4100074
"El Prat de Llobregat 01 - Ramona Via","Demogràfic","Població assignada de 55-64 anys (n)",1437,1490,2927,485653,501618,987271
"El Prat de Llobregat 01 - Ramona Via","Demogràfic","Població assignada de 65 anys o més (n)",1918,2554,4472,631736,839322,1471058
"El Prat de Llobregat 01 - Ramona Via","Demogràfic","Població assignada total (n)",10989,11400,22389,3771014,3882239,7653253
"El Prat de Llobregat 02 - Sant Cosme I","Demogràfic","Població assignada de 0-14 anys (n)",2216,2165,4381,563490,531360,1094850
"El Prat de Llobregat 02 - Sant Cosme I","Demogràfic","Població assignada de 15-54 anys (n)",8383,8167,16550,2090135,2009939,4100074
"El Prat de Llobregat 02 - Sant Cosme I","Demogràfic","Població assignada de 55-64 anys (n)",1879,2179,4058,485653,501618,987271
"El Prat de Llobregat 02 - Sant Cosme I","Demogràfic","Població assignada de 65 anys o més (n)",2910,3761,6671,631736,839322,1471058
"El Prat de Llobregat 02 - Sant Cosme I","Demogràfic","Població assignada total (n)",15388,16272,31660,3771014,3882239,7653253
"El Prat de Llobregat 03 - Dr. Pujol Capçada","Demogràfic","Població assignada de 0-14 anys (n)",891,866,1757,563490,531360,1094850
"El Prat de Llobregat 03 - Dr. Pujol Capçada","Demogràfic","Població assignada de 15-54 anys (n)",2781,2532,5313,2090135,2009939,4100074
"El Prat de Llobregat 03 - Dr. Pujol Capçada","Demogràfic","Població assignada de 55-64 anys (n)",639,681,1320,485653,501618,987271
"El Prat de Llobregat 03 - Dr. Pujol Capçada","Demogràfic","Població assignada de 65 anys o més (n)",690,1037,1727,631736,839322,1471058
"El Prat de Llobregat 03 - Dr. Pujol Capçada","Demogràfic","Població assignada total (n)",5001,5116,10117,3771014,3882239,7653253
"El Vendrell","Demogràfic","Població assignada de 0-14 anys (n)",3791,3541,7332,563490,531360,1094850
"El Vendrell","Demogràfic","Població assignada de 15-54 anys (n)",12520,12078,24598,2090135,2009939,4100074
"El Vendrell","Demogràfic","Població assignada de 55-64 anys (n)",3009,2907,5916,485653,501618,987271
"El Vendrell","Demogràfic","Població assignada de 65 anys o més (n)",4139,4969,9108,631736,839322,1471058
"El Vendrell","Demogràfic","Població assignada total (n)",23459,23495,46954,3771014,3882239,7653253
"Esparreguera","Demogràfic","Població assignada de 0-14 anys (n)",2135,1942,4077,563490,531360,1094850
"Esparreguera","Demogràfic","Població assignada de 15-54 anys (n)",7797,7112,14909,2090135,2009939,4100074
"Esparreguera","Demogràfic","Població assignada de 55-64 anys (n)",1765,1704,3469,485653,501618,987271
"Esparreguera","Demogràfic","Població assignada de 65 anys o més (n)",2123,2514,4637,631736,839322,1471058
"Esparreguera","Demogràfic","Població assignada total (n)",13820,13272,27092,3771014,3882239,7653253
"Esplugues de Llobregat 01 - Can Vidalet","Demogràfic","Població assignada de 0-14 anys (n)",1224,1178,2402,563490,531360,1094850
"Esplugues de Llobregat 01 - Can Vidalet","Demogràfic","Població assignada de 15-54 anys (n)",4540,4586,9126,2090135,2009939,4100074
"Esplugues de Llobregat 01 - Can Vidalet","Demogràfic","Població assignada de 55-64 anys (n)",980,1160,2140,485653,501618,987271
"Esplugues de Llobregat 01 - Can Vidalet","Demogràfic","Població assignada de 65 anys o més (n)",1777,2330,4107,631736,839322,1471058
"Esplugues de Llobregat 01 - Can Vidalet","Demogràfic","Població assignada total (n)",8521,9254,17775,3771014,3882239,7653253
"Esplugues de Llobregat 02 - Lluís Millet","Demogràfic","Població assignada de 0-14 anys (n)",2184,2041,4225,563490,531360,1094850
"Esplugues de Llobregat 02 - Lluís Millet","Demogràfic","Població assignada de 15-54 anys (n)",7361,7636,14997,2090135,2009939,4100074
"Esplugues de Llobregat 02 - Lluís Millet","Demogràfic","Població assignada de 55-64 anys (n)",1791,2116,3907,485653,501618,987271
"Esplugues de Llobregat 02 - Lluís Millet","Demogràfic","Població assignada de 65 anys o més (n)",2951,4037,6988,631736,839322,1471058
"Esplugues de Llobregat 02 - Lluís Millet","Demogràfic","Població assignada total (n)",14287,15830,30117,3771014,3882239,7653253
"Falset","Demogràfic","Població assignada de 0-14 anys (n)",423,401,824,563490,531360,1094850
"Falset","Demogràfic","Població assignada de 15-54 anys (n)",1653,1375,3028,2090135,2009939,4100074
"Falset","Demogràfic","Població assignada de 55-64 anys (n)",486,459,945,485653,501618,987271
"Falset","Demogràfic","Població assignada de 65 anys o més (n)",801,984,1785,631736,839322,1471058
"Falset","Demogràfic","Població assignada total (n)",3363,3219,6582,3771014,3882239,7653253
"Figueres","Demogràfic","Població assignada de 0-14 anys (n)",4092,3862,7954,563490,531360,1094850
"Figueres","Demogràfic","Població assignada de 15-54 anys (n)",13676,13150,26826,2090135,2009939,4100074
"Figueres","Demogràfic","Població assignada de 55-64 anys (n)",2874,2898,5772,485653,501618,987271
"Figueres","Demogràfic","Població assignada de 65 anys o més (n)",3299,4479,7778,631736,839322,1471058
"Figueres","Demogràfic","Població assignada total (n)",23941,24389,48330,3771014,3882239,7653253
"Flix","Demogràfic","Població assignada de 0-14 anys (n)",407,369,776,563490,531360,1094850
"Flix","Demogràfic","Població assignada de 15-54 anys (n)",1665,1405,3070,2090135,2009939,4100074
"Flix","Demogràfic","Població assignada de 55-64 anys (n)",598,559,1157,485653,501618,987271
"Flix","Demogràfic","Població assignada de 65 anys o més (n)",1010,1157,2167,631736,839322,1471058
"Flix","Demogràfic","Població assignada total (n)",3680,3490,7170,3771014,3882239,7653253
"Gavà 01","Demogràfic","Població assignada de 0-14 anys (n)",1671,1538,3209,563490,531360,1094850
"Gavà 01","Demogràfic","Població assignada de 15-54 anys (n)",6046,5886,11932,2090135,2009939,4100074
"Gavà 01","Demogràfic","Població assignada de 55-64 anys (n)",1440,1552,2992,485653,501618,987271
"Gavà 01","Demogràfic","Població assignada de 65 anys o més (n)",1783,2378,4161,631736,839322,1471058
"Gavà 01","Demogràfic","Població assignada total (n)",10940,11354,22294,3771014,3882239,7653253
"Gavà 02","Demogràfic","Població assignada de 0-14 anys (n)",2051,1932,3983,563490,531360,1094850
"Gavà 02","Demogràfic","Població assignada de 15-54 anys (n)",6888,7064,13952,2090135,2009939,4100074
"Gavà 02","Demogràfic","Població assignada de 55-64 anys (n)",1709,1764,3473,485653,501618,987271
"Gavà 02","Demogràfic","Població assignada de 65 anys o més (n)",2049,2584,4633,631736,839322,1471058
"Gavà 02","Demogràfic","Població assignada total (n)",12697,13344,26041,3771014,3882239,7653253
"Girona 01 - Santa Clara","Demogràfic","Població assignada de 0-14 anys (n)",1592,1509,3101,563490,531360,1094850
"Girona 01 - Santa Clara","Demogràfic","Població assignada de 15-54 anys (n)",6901,7496,14397,2090135,2009939,4100074
"Girona 01 - Santa Clara","Demogràfic","Població assignada de 55-64 anys (n)",1458,1632,3090,485653,501618,987271
"Girona 01 - Santa Clara","Demogràfic","Població assignada de 65 anys o més (n)",1780,2465,4245,631736,839322,1471058
"Girona 01 - Santa Clara","Demogràfic","Població assignada total (n)",11731,13102,24833,3771014,3882239,7653253
"Girona 02 - Can Gibert del Pla","Demogràfic","Població assignada de 0-14 anys (n)",2643,2445,5088,563490,531360,1094850
"Girona 02 - Can Gibert del Pla","Demogràfic","Població assignada de 15-54 anys (n)",9113,8931,18044,2090135,2009939,4100074
"Girona 02 - Can Gibert del Pla","Demogràfic","Població assignada de 55-64 anys (n)",1582,1752,3334,485653,501618,987271
"Girona 02 - Can Gibert del Pla","Demogràfic","Població assignada de 65 anys o més (n)",1861,2626,4487,631736,839322,1471058
"Girona 02 - Can Gibert del Pla","Demogràfic","Població assignada total (n)",15199,15754,30953,3771014,3882239,7653253
"Girona 03 - Montilivi","Demogràfic","Població assignada de 0-14 anys (n)",3081,2820,5901,563490,531360,1094850
"Girona 03 - Montilivi","Demogràfic","Població assignada de 15-54 anys (n)",9654,10116,19770,2090135,2009939,4100074
"Girona 03 - Montilivi","Demogràfic","Població assignada de 55-64 anys (n)",2042,2256,4298,485653,501618,987271
"Girona 03 - Montilivi","Demogràfic","Població assignada de 65 anys o més (n)",2503,3465,5968,631736,839322,1471058
"Girona 03 - Montilivi","Demogràfic","Població assignada total (n)",17280,18657,35937,3771014,3882239,7653253
"Girona 04 - Taialà","Demogràfic","Població assignada de 0-14 anys (n)",1231,1222,2453,563490,531360,1094850
"Girona 04 - Taialà","Demogràfic","Població assignada de 15-54 anys (n)",4343,4173,8516,2090135,2009939,4100074
"Girona 04 - Taialà","Demogràfic","Població assignada de 55-64 anys (n)",964,1025,1989,485653,501618,987271
"Girona 04 - Taialà","Demogràfic","Població assignada de 65 anys o més (n)",1210,1495,2705,631736,839322,1471058
"Girona 04 - Taialà","Demogràfic","Població assignada total (n)",7748,7915,15663,3771014,3882239,7653253
"Granollers 01 - Oest - Canovelles","Demogràfic","Població assignada de 0-14 anys (n)",1928,1801,3729,563490,531360,1094850
"Granollers 01 - Oest - Canovelles","Demogràfic","Població assignada de 15-54 anys (n)",6701,5517,12218,2090135,2009939,4100074
"Granollers 01 - Oest - Canovelles","Demogràfic","Població assignada de 55-64 anys (n)",1374,1311,2685,485653,501618,987271
"Granollers 01 - Oest - Canovelles","Demogràfic","Població assignada de 65 anys o més (n)",1647,2029,3676,631736,839322,1471058
"Granollers 01 - Oest - Canovelles","Demogràfic","Població assignada total (n)",11650,10658,22308,3771014,3882239,7653253
"Granollers 02 - Nord - Les Franqueses","Demogràfic","Població assignada de 0-14 anys (n)",2645,2482,5127,563490,531360,1094850
"Granollers 02 - Nord - Les Franqueses","Demogràfic","Població assignada de 15-54 anys (n)",8660,7966,16626,2090135,2009939,4100074
"Granollers 02 - Nord - Les Franqueses","Demogràfic","Població assignada de 55-64 anys (n)",1805,1815,3620,485653,501618,987271
"Granollers 02 - Nord - Les Franqueses","Demogràfic","Població assignada de 65 anys o més (n)",2059,2593,4652,631736,839322,1471058
"Granollers 02 - Nord - Les Franqueses","Demogràfic","Població assignada total (n)",15169,14856,30025,3771014,3882239,7653253
"Granollers 03 - Centre - Est","Demogràfic","Població assignada de 0-14 anys (n)",1929,1770,3699,563490,531360,1094850
"Granollers 03 - Centre - Est","Demogràfic","Població assignada de 15-54 anys (n)",7911,7800,15711,2090135,2009939,4100074
"Granollers 03 - Centre - Est","Demogràfic","Població assignada de 55-64 anys (n)",1886,2199,4085,485653,501618,987271
"Granollers 03 - Centre - Est","Demogràfic","Població assignada de 65 anys o més (n)",2545,3498,6043,631736,839322,1471058
"Granollers 03 - Centre - Est","Demogràfic","Població assignada total (n)",14271,15267,29538,3771014,3882239,7653253
"Granollers 04 - Sud - Sant Miquel","Demogràfic","Població assignada de 0-14 anys (n)",1230,1187,2417,563490,531360,1094850
"Granollers 04 - Sud - Sant Miquel","Demogràfic","Població assignada de 15-54 anys (n)",4936,4457,9393,2090135,2009939,4100074
"Granollers 04 - Sud - Sant Miquel","Demogràfic","Població assignada de 55-64 anys (n)",1122,1196,2318,485653,501618,987271
"Granollers 04 - Sud - Sant Miquel","Demogràfic","Població assignada de 65 anys o més (n)",1338,1613,2951,631736,839322,1471058
"Granollers 04 - Sud - Sant Miquel","Demogràfic","Població assignada total (n)",8626,8453,17079,3771014,3882239,7653253
"Igualada 01","Demogràfic","Població assignada de 0-14 anys (n)",1697,1652,3349,563490,531360,1094850
"Igualada 01","Demogràfic","Població assignada de 15-54 anys (n)",6143,5669,11812,2090135,2009939,4100074
"Igualada 01","Demogràfic","Població assignada de 55-64 anys (n)",1385,1380,2765,485653,501618,987271
"Igualada 01","Demogràfic","Població assignada de 65 anys o més (n)",1867,2563,4430,631736,839322,1471058
"Igualada 01","Demogràfic","Població assignada total (n)",11092,11264,22356,3771014,3882239,7653253
"Igualada 02","Demogràfic","Població assignada de 0-14 anys (n)",1713,1556,3269,563490,531360,1094850
"Igualada 02","Demogràfic","Població assignada de 15-54 anys (n)",5319,5120,10439,2090135,2009939,4100074
"Igualada 02","Demogràfic","Població assignada de 55-64 anys (n)",1276,1394,2670,485653,501618,987271
"Igualada 02","Demogràfic","Població assignada de 65 anys o més (n)",1729,2294,4023,631736,839322,1471058
"Igualada 02","Demogràfic","Població assignada total (n)",10037,10364,20401,3771014,3882239,7653253
"La Bisbal d'Empordà","Demogràfic","Població assignada de 0-14 anys (n)",1417,1274,2691,563490,531360,1094850
"La Bisbal d'Empordà","Demogràfic","Població assignada de 15-54 anys (n)",4356,4047,8403,2090135,2009939,4100074
"La Bisbal d'Empordà","Demogràfic","Població assignada de 55-64 anys (n)",1136,1113,2249,485653,501618,987271
"La Bisbal d'Empordà","Demogràfic","Població assignada de 65 anys o més (n)",1445,1730,3175,631736,839322,1471058
"La Bisbal d'Empordà","Demogràfic","Població assignada total (n)",8354,8164,16518,3771014,3882239,7653253
"La Garriga","Demogràfic","Població assignada de 0-14 anys (n)",2250,2086,4336,563490,531360,1094850
"La Garriga","Demogràfic","Població assignada de 15-54 anys (n)",7647,7613,15260,2090135,2009939,4100074
"La Garriga","Demogràfic","Població assignada de 55-64 anys (n)",2036,2021,4057,485653,501618,987271
"La Garriga","Demogràfic","Població assignada de 65 anys o més (n)",2321,3013,5334,631736,839322,1471058
"La Garriga","Demogràfic","Població assignada total (n)",14254,14733,28987,3771014,3882239,7653253
"La Granadella","Demogràfic","Població assignada de 0-14 anys (n)",121,117,238,563490,531360,1094850
"La Granadella","Demogràfic","Població assignada de 15-54 anys (n)",596,407,1003,2090135,2009939,4100074
"La Granadella","Demogràfic","Població assignada de 55-64 anys (n)",226,178,404,485653,501618,987271
"La Granadella","Demogràfic","Població assignada de 65 anys o més (n)",368,391,759,631736,839322,1471058
"La Granadella","Demogràfic","Població assignada total (n)",1311,1093,2404,3771014,3882239,7653253
"La Jonquera","Demogràfic","Població assignada de 0-14 anys (n)",502,472,974,563490,531360,1094850
"La Jonquera","Demogràfic","Població assignada de 15-54 anys (n)",1900,1819,3719,2090135,2009939,4100074
"La Jonquera","Demogràfic","Població assignada de 55-64 anys (n)",485,473,958,485653,501618,987271
"La Jonquera","Demogràfic","Població assignada de 65 anys o més (n)",661,748,1409,631736,839322,1471058
"La Jonquera","Demogràfic","Població assignada total (n)",3548,3512,7060,3771014,3882239,7653253
"La Llagosta","Demogràfic","Població assignada de 0-14 anys (n)",1048,1042,2090,563490,531360,1094850
"La Llagosta","Demogràfic","Població assignada de 15-54 anys (n)",3853,3628,7481,2090135,2009939,4100074
"La Llagosta","Demogràfic","Població assignada de 55-64 anys (n)",841,850,1691,485653,501618,987271
"La Llagosta","Demogràfic","Població assignada de 65 anys o més (n)",1161,1503,2664,631736,839322,1471058
"La Llagosta","Demogràfic","Població assignada total (n)",6903,7023,13926,3771014,3882239,7653253
"La Pobla de Segur","Demogràfic","Població assignada de 0-14 anys (n)",319,298,617,563490,531360,1094850
"La Pobla de Segur","Demogràfic","Població assignada de 15-54 anys (n)",1053,914,1967,2090135,2009939,4100074
"La Pobla de Segur","Demogràfic","Població assignada de 55-64 anys (n)",294,306,600,485653,501618,987271
"La Pobla de Segur","Demogràfic","Població assignada de 65 anys o més (n)",549,616,1165,631736,839322,1471058
"La Pobla de Segur","Demogràfic","Població assignada total (n)",2215,2134,4349,3771014,3882239,7653253
"La Ràpita - Alcanar","Demogràfic","Població assignada de 0-14 anys (n)",1596,1580,3176,563490,531360,1094850
"La Ràpita - Alcanar","Demogràfic","Població assignada de 15-54 anys (n)",6033,5832,11865,2090135,2009939,4100074
"La Ràpita - Alcanar","Demogràfic","Població assignada de 55-64 anys (n)",1663,1668,3331,485653,501618,987271
"La Ràpita - Alcanar","Demogràfic","Població assignada de 65 anys o més (n)",2457,2940,5397,631736,839322,1471058
"La Ràpita - Alcanar","Demogràfic","Població assignada total (n)",11749,12020,23769,3771014,3882239,7653253
"La Roca del Vallès","Demogràfic","Població assignada de 0-14 anys (n)",791,741,1532,563490,531360,1094850
"La Roca del Vallès","Demogràfic","Població assignada de 15-54 anys (n)",2949,2817,5766,2090135,2009939,4100074
"La Roca del Vallès","Demogràfic","Població assignada de 55-64 anys (n)",722,679,1401,485653,501618,987271
"La Roca del Vallès","Demogràfic","Població assignada de 65 anys o més (n)",790,920,1710,631736,839322,1471058
"La Roca del Vallès","Demogràfic","Població assignada total (n)",5252,5157,10409,3771014,3882239,7653253
"La Selva del Camp","Demogràfic","Població assignada de 0-14 anys (n)",542,493,1035,563490,531360,1094850
"La Selva del Camp","Demogràfic","Població assignada de 15-54 anys (n)",1857,1829,3686,2090135,2009939,4100074
"La Selva del Camp","Demogràfic","Població assignada de 55-64 anys (n)",540,478,1018,485653,501618,987271
"La Selva del Camp","Demogràfic","Població assignada de 65 anys o més (n)",541,648,1189,631736,839322,1471058
"La Selva del Camp","Demogràfic","Població assignada total (n)",3480,3448,6928,3771014,3882239,7653253
"La Seu d'Urgell","Demogràfic","Població assignada de 0-14 anys (n)",1090,1063,2153,563490,531360,1094850
"La Seu d'Urgell","Demogràfic","Població assignada de 15-54 anys (n)",4039,3925,7964,2090135,2009939,4100074
"La Seu d'Urgell","Demogràfic","Població assignada de 55-64 anys (n)",1230,1176,2406,485653,501618,987271
"La Seu d'Urgell","Demogràfic","Població assignada de 65 anys o més (n)",1567,1852,3419,631736,839322,1471058
"La Seu d'Urgell","Demogràfic","Població assignada total (n)",7926,8016,15942,3771014,3882239,7653253
"La Vall del Ges - Torelló","Demogràfic","Població assignada de 0-14 anys (n)",1487,1393,2880,563490,531360,1094850
"La Vall del Ges - Torelló","Demogràfic","Població assignada de 15-54 anys (n)",5051,4651,9702,2090135,2009939,4100074
"La Vall del Ges - Torelló","Demogràfic","Població assignada de 55-64 anys (n)",1314,1337,2651,485653,501618,987271
"La Vall del Ges - Torelló","Demogràfic","Població assignada de 65 anys o més (n)",1742,2133,3875,631736,839322,1471058
"La Vall del Ges - Torelló","Demogràfic","Població assignada total (n)",9594,9514,19108,3771014,3882239,7653253
"La Vall d'en Bas","Demogràfic","Població assignada de 0-14 anys (n)",535,470,1005,563490,531360,1094850
"La Vall d'en Bas","Demogràfic","Població assignada de 15-54 anys (n)",1514,1497,3011,2090135,2009939,4100074
"La Vall d'en Bas","Demogràfic","Població assignada de 55-64 anys (n)",454,414,868,485653,501618,987271
"La Vall d'en Bas","Demogràfic","Població assignada de 65 anys o més (n)",671,778,1449,631736,839322,1471058
"La Vall d'en Bas","Demogràfic","Població assignada total (n)",3174,3159,6333,3771014,3882239,7653253
"L'Aldea - Camarles - L'Ampolla","Demogràfic","Població assignada de 0-14 anys (n)",781,652,1433,563490,531360,1094850
"L'Aldea - Camarles - L'Ampolla","Demogràfic","Població assignada de 15-54 anys (n)",2890,2417,5307,2090135,2009939,4100074
"L'Aldea - Camarles - L'Ampolla","Demogràfic","Població assignada de 55-64 anys (n)",696,676,1372,485653,501618,987271
"L'Aldea - Camarles - L'Ampolla","Demogràfic","Població assignada de 65 anys o més (n)",1168,1318,2486,631736,839322,1471058
"L'Aldea - Camarles - L'Ampolla","Demogràfic","Població assignada total (n)",5535,5063,10598,3771014,3882239,7653253
"L'Ametlla de Mar - El Perelló","Demogràfic","Població assignada de 0-14 anys (n)",620,609,1229,563490,531360,1094850
"L'Ametlla de Mar - El Perelló","Demogràfic","Població assignada de 15-54 anys (n)",2351,2151,4502,2090135,2009939,4100074
"L'Ametlla de Mar - El Perelló","Demogràfic","Població assignada de 55-64 anys (n)",609,587,1196,485653,501618,987271
"L'Ametlla de Mar - El Perelló","Demogràfic","Població assignada de 65 anys o més (n)",1085,1239,2324,631736,839322,1471058
"L'Ametlla de Mar - El Perelló","Demogràfic","Població assignada total (n)",4665,4586,9251,3771014,3882239,7653253
"Les Borges Blanques","Demogràfic","Població assignada de 0-14 anys (n)",1082,1037,2119,563490,531360,1094850
"Les Borges Blanques","Demogràfic","Població assignada de 15-54 anys (n)",4144,3329,7473,2090135,2009939,4100074
"Les Borges Blanques","Demogràfic","Població assignada de 55-64 anys (n)",1128,985,2113,485653,501618,987271
"Les Borges Blanques","Demogràfic","Població assignada de 65 anys o més (n)",1816,2136,3952,631736,839322,1471058
"Les Borges Blanques","Demogràfic","Població assignada total (n)",8170,7487,15657,3771014,3882239,7653253
"Les Borges del Camp","Demogràfic","Població assignada de 0-14 anys (n)",513,427,940,563490,531360,1094850
"Les Borges del Camp","Demogràfic","Població assignada de 15-54 anys (n)",1760,1580,3340,2090135,2009939,4100074
"Les Borges del Camp","Demogràfic","Població assignada de 55-64 anys (n)",479,440,919,485653,501618,987271
"Les Borges del Camp","Demogràfic","Població assignada de 65 anys o més (n)",603,729,1332,631736,839322,1471058
"Les Borges del Camp","Demogràfic","Població assignada total (n)",3355,3176,6531,3771014,3882239,7653253
"Les Roquetes - Canyelles","Demogràfic","Població assignada de 0-14 anys (n)",1601,1532,3133,563490,531360,1094850
"Les Roquetes - Canyelles","Demogràfic","Població assignada de 15-54 anys (n)",5512,5249,10761,2090135,2009939,4100074
"Les Roquetes - Canyelles","Demogràfic","Població assignada de 55-64 anys (n)",1249,1257,2506,485653,501618,987271
"Les Roquetes - Canyelles","Demogràfic","Població assignada de 65 anys o més (n)",1385,1554,2939,631736,839322,1471058
"Les Roquetes - Canyelles","Demogràfic","Població assignada total (n)",9747,9592,19339,3771014,3882239,7653253
"L'Escala","Demogràfic","Població assignada de 0-14 anys (n)",1105,1123,2228,563490,531360,1094850
"L'Escala","Demogràfic","Població assignada de 15-54 anys (n)",4157,3752,7909,2090135,2009939,4100074
"L'Escala","Demogràfic","Població assignada de 55-64 anys (n)",1086,1031,2117,485653,501618,987271
"L'Escala","Demogràfic","Població assignada de 65 anys o més (n)",1532,1759,3291,631736,839322,1471058
"L'Escala","Demogràfic","Població assignada total (n)",7880,7665,15545,3771014,3882239,7653253
"L'Hospitalet de Llobregat 01 - Centre","Demogràfic","Població assignada de 0-14 anys (n)",2063,2015,4078,563490,531360,1094850
"L'Hospitalet de Llobregat 01 - Centre","Demogràfic","Població assignada de 15-54 anys (n)",7610,7511,15121,2090135,2009939,4100074
"L'Hospitalet de Llobregat 01 - Centre","Demogràfic","Població assignada de 55-64 anys (n)",1711,1929,3640,485653,501618,987271
"L'Hospitalet de Llobregat 01 - Centre","Demogràfic","Població assignada de 65 anys o més (n)",2734,3776,6510,631736,839322,1471058
"L'Hospitalet de Llobregat 01 - Centre","Demogràfic","Població assignada total (n)",14118,15231,29349,3771014,3882239,7653253
"L'Hospitalet de Llobregat 02 - Sant Josep","Demogràfic","Població assignada de 0-14 anys (n)",1216,1178,2394,563490,531360,1094850
"L'Hospitalet de Llobregat 02 - Sant Josep","Demogràfic","Població assignada de 15-54 anys (n)",5686,5605,11291,2090135,2009939,4100074
"L'Hospitalet de Llobregat 02 - Sant Josep","Demogràfic","Població assignada de 55-64 anys (n)",1328,1484,2812,485653,501618,987271
"L'Hospitalet de Llobregat 02 - Sant Josep","Demogràfic","Població assignada de 65 anys o més (n)",2309,3008,5317,631736,839322,1471058
"L'Hospitalet de Llobregat 02 - Sant Josep","Demogràfic","Població assignada total (n)",10539,11275,21814,3771014,3882239,7653253
"L'Hospitalet de Llobregat 03 - Collblanc","Demogràfic","Població assignada de 0-14 anys (n)",1787,1679,3466,563490,531360,1094850
"L'Hospitalet de Llobregat 03 - Collblanc","Demogràfic","Població assignada de 15-54 anys (n)",7271,7219,14490,2090135,2009939,4100074
"L'Hospitalet de Llobregat 03 - Collblanc","Demogràfic","Població assignada de 55-64 anys (n)",1388,1478,2866,485653,501618,987271
"L'Hospitalet de Llobregat 03 - Collblanc","Demogràfic","Població assignada de 65 anys o més (n)",1674,2547,4221,631736,839322,1471058
"L'Hospitalet de Llobregat 03 - Collblanc","Demogràfic","Població assignada total (n)",12120,12923,25043,3771014,3882239,7653253
"L'Hospitalet de Llobregat 04 - La Torrassa","Demogràfic","Població assignada de 0-14 anys (n)",2092,1973,4065,563490,531360,1094850
"L'Hospitalet de Llobregat 04 - La Torrassa","Demogràfic","Població assignada de 15-54 anys (n)",8221,8237,16458,2090135,2009939,4100074
"L'Hospitalet de Llobregat 04 - La Torrassa","Demogràfic","Població assignada de 55-64 anys (n)",1544,1667,3211,485653,501618,987271
"L'Hospitalet de Llobregat 04 - La Torrassa","Demogràfic","Població assignada de 65 anys o més (n)",1581,2476,4057,631736,839322,1471058
"L'Hospitalet de Llobregat 04 - La Torrassa","Demogràfic","Població assignada total (n)",13438,14353,27791,3771014,3882239,7653253
"L'Hospitalet de Llobregat 05 - Santa Eulàlia Nord","Demogràfic","Població assignada de 0-14 anys (n)",1412,1241,2653,563490,531360,1094850
"L'Hospitalet de Llobregat 05 - Santa Eulàlia Nord","Demogràfic","Població assignada de 15-54 anys (n)",5080,5106,10186,2090135,2009939,4100074
"L'Hospitalet de Llobregat 05 - Santa Eulàlia Nord","Demogràfic","Població assignada de 55-64 anys (n)",1085,1273,2358,485653,501618,987271
"L'Hospitalet de Llobregat 05 - Santa Eulàlia Nord","Demogràfic","Població assignada de 65 anys o més (n)",1878,2479,4357,631736,839322,1471058
"L'Hospitalet de Llobregat 05 - Santa Eulàlia Nord","Demogràfic","Població assignada total (n)",9455,10099,19554,3771014,3882239,7653253
"L'Hospitalet de Llobregat 06 - Santa Eulàlia Sud","Demogràfic","Població assignada de 0-14 anys (n)",1960,1796,3756,563490,531360,1094850
"L'Hospitalet de Llobregat 06 - Santa Eulàlia Sud","Demogràfic","Població assignada de 15-54 anys (n)",6987,6743,13730,2090135,2009939,4100074
"L'Hospitalet de Llobregat 06 - Santa Eulàlia Sud","Demogràfic","Població assignada de 55-64 anys (n)",1370,1528,2898,485653,501618,987271
"L'Hospitalet de Llobregat 06 - Santa Eulàlia Sud","Demogràfic","Població assignada de 65 anys o més (n)",2061,2649,4710,631736,839322,1471058
"L'Hospitalet de Llobregat 06 - Santa Eulàlia Sud","Demogràfic","Població assignada total (n)",12378,12716,25094,3771014,3882239,7653253
"L'Hospitalet de Llobregat 07 - La Florida Nord","Demogràfic","Població assignada de 0-14 anys (n)",563,522,1085,563490,531360,1094850
"L'Hospitalet de Llobregat 07 - La Florida Nord","Demogràfic","Població assignada de 15-54 anys (n)",6864,6624,13488,2090135,2009939,4100074
"L'Hospitalet de Llobregat 07 - La Florida Nord","Demogràfic","Població assignada de 55-64 anys (n)",1312,1409,2721,485653,501618,987271
"L'Hospitalet de Llobregat 07 - La Florida Nord","Demogràfic","Població assignada de 65 anys o més (n)",1496,2208,3704,631736,839322,1471058
"L'Hospitalet de Llobregat 07 - La Florida Nord","Demogràfic","Població assignada total (n)",10235,10763,20998,3771014,3882239,7653253
"L'Hospitalet de Llobregat 08 - La Florida Sud","Demogràfic","Població assignada de 0-14 anys (n)",2732,2637,5369,563490,531360,1094850
"L'Hospitalet de Llobregat 08 - La Florida Sud","Demogràfic","Població assignada de 15-54 anys (n)",6707,6356,13063,2090135,2009939,4100074
"L'Hospitalet de Llobregat 08 - La Florida Sud","Demogràfic","Població assignada de 55-64 anys (n)",1254,1376,2630,485653,501618,987271
"L'Hospitalet de Llobregat 08 - La Florida Sud","Demogràfic","Població assignada de 65 anys o més (n)",1757,2403,4160,631736,839322,1471058
"L'Hospitalet de Llobregat 08 - La Florida Sud","Demogràfic","Població assignada total (n)",12450,12772,25222,3771014,3882239,7653253
"L'Hospitalet de Llobregat 09 - Pubilla Cases","Demogràfic","Població assignada de 0-14 anys (n)",2233,2077,4310,563490,531360,1094850
"L'Hospitalet de Llobregat 09 - Pubilla Cases","Demogràfic","Població assignada de 15-54 anys (n)",8794,8590,17384,2090135,2009939,4100074
"L'Hospitalet de Llobregat 09 - Pubilla Cases","Demogràfic","Població assignada de 55-64 anys (n)",1634,1831,3465,485653,501618,987271
"L'Hospitalet de Llobregat 09 - Pubilla Cases","Demogràfic","Població assignada de 65 anys o més (n)",1941,2905,4846,631736,839322,1471058
"L'Hospitalet de Llobregat 09 - Pubilla Cases","Demogràfic","Població assignada total (n)",14602,15403,30005,3771014,3882239,7653253
"L'Hospitalet de Llobregat 10 - Can Serra","Demogràfic","Població assignada de 0-14 anys (n)",541,549,1090,563490,531360,1094850
"L'Hospitalet de Llobregat 10 - Can Serra","Demogràfic","Població assignada de 15-54 anys (n)",2597,2389,4986,2090135,2009939,4100074
"L'Hospitalet de Llobregat 10 - Can Serra","Demogràfic","Població assignada de 55-64 anys (n)",597,620,1217,485653,501618,987271
"L'Hospitalet de Llobregat 10 - Can Serra","Demogràfic","Població assignada de 65 anys o més (n)",1253,1702,2955,631736,839322,1471058
"L'Hospitalet de Llobregat 10 - Can Serra","Demogràfic","Població assignada total (n)",4988,5260,10248,3771014,3882239,7653253
"L'Hospitalet de Llobregat 11 - El Gornal","Demogràfic","Població assignada de 0-14 anys (n)",553,478,1031,563490,531360,1094850
"L'Hospitalet de Llobregat 11 - El Gornal","Demogràfic","Població assignada de 15-54 anys (n)",2043,1859,3902,2090135,2009939,4100074
"L'Hospitalet de Llobregat 11 - El Gornal","Demogràfic","Població assignada de 55-64 anys (n)",436,475,911,485653,501618,987271
"L'Hospitalet de Llobregat 11 - El Gornal","Demogràfic","Població assignada de 65 anys o més (n)",581,825,1406,631736,839322,1471058
"L'Hospitalet de Llobregat 11 - El Gornal","Demogràfic","Població assignada total (n)",3613,3637,7250,3771014,3882239,7653253
"L'Hospitalet de Llobregat 12 - Bellvitge","Demogràfic","Població assignada de 0-14 anys (n)",1567,1444,3011,563490,531360,1094850
"L'Hospitalet de Llobregat 12 - Bellvitge","Demogràfic","Població assignada de 15-54 anys (n)",6475,6055,12530,2090135,2009939,4100074
"L'Hospitalet de Llobregat 12 - Bellvitge","Demogràfic","Població assignada de 55-64 anys (n)",1372,1456,2828,485653,501618,987271
"L'Hospitalet de Llobregat 12 - Bellvitge","Demogràfic","Població assignada de 65 anys o més (n)",2902,3977,6879,631736,839322,1471058
"L'Hospitalet de Llobregat 12 - Bellvitge","Demogràfic","Població assignada total (n)",12316,12932,25248,3771014,3882239,7653253
"Llançà","Demogràfic","Població assignada de 0-14 anys (n)",402,385,787,563490,531360,1094850
"Llançà","Demogràfic","Població assignada de 15-54 anys (n)",1660,1628,3288,2090135,2009939,4100074
"Llançà","Demogràfic","Població assignada de 55-64 anys (n)",507,500,1007,485653,501618,987271
"Llançà","Demogràfic","Població assignada de 65 anys o més (n)",733,948,1681,631736,839322,1471058
"Llançà","Demogràfic","Població assignada total (n)",3302,3461,6763,3771014,3882239,7653253
"Lleida 01 - Centre Històric - Rambla de Ferran - Estació","Demogràfic","Població assignada de 0-14 anys (n)",1206,1138,2344,563490,531360,1094850
"Lleida 01 - Centre Històric - Rambla de Ferran - Estació","Demogràfic","Població assignada de 15-54 anys (n)",6229,4950,11179,2090135,2009939,4100074
"Lleida 01 - Centre Històric - Rambla de Ferran - Estació","Demogràfic","Població assignada de 55-64 anys (n)",1285,1128,2413,485653,501618,987271
"Lleida 01 - Centre Històric - Rambla de Ferran - Estació","Demogràfic","Població assignada de 65 anys o més (n)",1119,1549,2668,631736,839322,1471058
"Lleida 01 - Centre Històric - Rambla de Ferran - Estació","Demogràfic","Població assignada total (n)",9839,8765,18604,3771014,3882239,7653253
"Lleida 02 - Primer de Maig","Demogràfic","Població assignada de 0-14 anys (n)",1840,1715,3555,563490,531360,1094850
"Lleida 02 - Primer de Maig","Demogràfic","Població assignada de 15-54 anys (n)",6565,5986,12551,2090135,2009939,4100074
"Lleida 02 - Primer de Maig","Demogràfic","Població assignada de 55-64 anys (n)",1642,1775,3417,485653,501618,987271
"Lleida 02 - Primer de Maig","Demogràfic","Població assignada de 65 anys o més (n)",2160,3077,5237,631736,839322,1471058
"Lleida 02 - Primer de Maig","Demogràfic","Població assignada total (n)",12207,12553,24760,3771014,3882239,7653253
"Lleida 03 - Eixample","Demogràfic","Població assignada de 0-14 anys (n)",1481,1503,2984,563490,531360,1094850
"Lleida 03 - Eixample","Demogràfic","Població assignada de 15-54 anys (n)",5909,5664,11573,2090135,2009939,4100074
"Lleida 03 - Eixample","Demogràfic","Població assignada de 55-64 anys (n)",1510,1680,3190,485653,501618,987271
"Lleida 03 - Eixample","Demogràfic","Població assignada de 65 anys o més (n)",2033,2794,4827,631736,839322,1471058
"Lleida 03 - Eixample","Demogràfic","Població assignada total (n)",10933,11641,22574,3771014,3882239,7653253
"Lleida 04 - Balàfia - Pardinyes - Lo Secà de Sant Pere","Demogràfic","Població assignada de 0-14 anys (n)",2054,1956,4010,563490,531360,1094850
"Lleida 04 - Balàfia - Pardinyes - Lo Secà de Sant Pere","Demogràfic","Població assignada de 15-54 anys (n)",7171,7042,14213,2090135,2009939,4100074
"Lleida 04 - Balàfia - Pardinyes - Lo Secà de Sant Pere","Demogràfic","Població assignada de 55-64 anys (n)",1811,1765,3576,485653,501618,987271
"Lleida 04 - Balàfia - Pardinyes - Lo Secà de Sant Pere","Demogràfic","Població assignada de 65 anys o més (n)",1651,2330,3981,631736,839322,1471058
"Lleida 04 - Balàfia - Pardinyes - Lo Secà de Sant Pere","Demogràfic","Població assignada total (n)",12687,13093,25780,3771014,3882239,7653253
"Lleida 05 - Cappont","Demogràfic","Població assignada de 0-14 anys (n)",1356,1356,2712,563490,531360,1094850
"Lleida 05 - Cappont","Demogràfic","Població assignada de 15-54 anys (n)",4671,4346,9017,2090135,2009939,4100074
"Lleida 05 - Cappont","Demogràfic","Població assignada de 55-64 anys (n)",1025,986,2011,485653,501618,987271
"Lleida 05 - Cappont","Demogràfic","Població assignada de 65 anys o més (n)",1041,1407,2448,631736,839322,1471058
"Lleida 05 - Cappont","Demogràfic","Població assignada total (n)",8093,8095,16188,3771014,3882239,7653253
"Lleida 06 - La Bordeta - Els Magraners","Demogràfic","Població assignada de 0-14 anys (n)",1432,1210,2642,563490,531360,1094850
"Lleida 06 - La Bordeta - Els Magraners","Demogràfic","Població assignada de 15-54 anys (n)",4642,4330,8972,2090135,2009939,4100074
"Lleida 06 - La Bordeta - Els Magraners","Demogràfic","Població assignada de 55-64 anys (n)",1094,1058,2152,485653,501618,987271
"Lleida 06 - La Bordeta - Els Magraners","Demogràfic","Població assignada de 65 anys o més (n)",1096,1371,2467,631736,839322,1471058
"Lleida 06 - La Bordeta - Els Magraners","Demogràfic","Població assignada total (n)",8264,7969,16233,3771014,3882239,7653253
"Lleida 07 - Onze de Setembre","Demogràfic","Població assignada de 0-14 anys (n)",1944,1843,3787,563490,531360,1094850
"Lleida 07 - Onze de Setembre","Demogràfic","Població assignada de 15-54 anys (n)",5067,4531,9598,2090135,2009939,4100074
"Lleida 07 - Onze de Setembre","Demogràfic","Població assignada de 55-64 anys (n)",1129,1166,2295,485653,501618,987271
"Lleida 07 - Onze de Setembre","Demogràfic","Població assignada de 65 anys o més (n)",1438,1880,3318,631736,839322,1471058
"Lleida 07 - Onze de Setembre","Demogràfic","Població assignada total (n)",9578,9420,18998,3771014,3882239,7653253
"Lleida Rural 01 - Nord","Demogràfic","Població assignada de 0-14 anys (n)",1161,1175,2336,563490,531360,1094850
"Lleida Rural 01 - Nord","Demogràfic","Població assignada de 15-54 anys (n)",6398,5319,11717,2090135,2009939,4100074
"Lleida Rural 01 - Nord","Demogràfic","Població assignada de 55-64 anys (n)",1485,1312,2797,485653,501618,987271
"Lleida Rural 01 - Nord","Demogràfic","Població assignada de 65 anys o més (n)",1716,2184,3900,631736,839322,1471058
"Lleida Rural 01 - Nord","Demogràfic","Població assignada total (n)",10760,9990,20750,3771014,3882239,7653253
"Lleida Rural 02 - Sud","Demogràfic","Població assignada de 0-14 anys (n)",503,461,964,563490,531360,1094850
"Lleida Rural 02 - Sud","Demogràfic","Població assignada de 15-54 anys (n)",2003,1703,3706,2090135,2009939,4100074
"Lleida Rural 02 - Sud","Demogràfic","Població assignada de 55-64 anys (n)",565,486,1051,485653,501618,987271
"Lleida Rural 02 - Sud","Demogràfic","Població assignada de 65 anys o més (n)",708,815,1523,631736,839322,1471058
"Lleida Rural 02 - Sud","Demogràfic","Població assignada total (n)",3779,3465,7244,3771014,3882239,7653253
"Lloret de Mar","Demogràfic","Població assignada de 0-14 anys (n)",3083,2971,6054,563490,531360,1094850
"Lloret de Mar","Demogràfic","Població assignada de 15-54 anys (n)",11866,10911,22777,2090135,2009939,4100074
"Lloret de Mar","Demogràfic","Població assignada de 55-64 anys (n)",2793,2795,5588,485653,501618,987271
"Lloret de Mar","Demogràfic","Població assignada de 65 anys o més (n)",3040,3724,6764,631736,839322,1471058
"Lloret de Mar","Demogràfic","Població assignada total (n)",20782,20401,41183,3771014,3882239,7653253
"Lluçanès","Demogràfic","Població assignada de 0-14 anys (n)",429,410,839,563490,531360,1094850
"Lluçanès","Demogràfic","Població assignada de 15-54 anys (n)",1423,1284,2707,2090135,2009939,4100074
"Lluçanès","Demogràfic","Població assignada de 55-64 anys (n)",494,496,990,485653,501618,987271
"Lluçanès","Demogràfic","Població assignada de 65 anys o més (n)",718,774,1492,631736,839322,1471058
"Lluçanès","Demogràfic","Població assignada total (n)",3064,2964,6028,3771014,3882239,7653253
"Malgrat de Mar","Demogràfic","Població assignada de 0-14 anys (n)",1969,1926,3895,563490,531360,1094850
"Malgrat de Mar","Demogràfic","Població assignada de 15-54 anys (n)",7555,7075,14630,2090135,2009939,4100074
"Malgrat de Mar","Demogràfic","Població assignada de 55-64 anys (n)",1826,1823,3649,485653,501618,987271
"Malgrat de Mar","Demogràfic","Població assignada de 65 anys o més (n)",2288,3051,5339,631736,839322,1471058
"Malgrat de Mar","Demogràfic","Població assignada total (n)",13638,13875,27513,3771014,3882239,7653253
"Manlleu","Demogràfic","Població assignada de 0-14 anys (n)",1853,1749,3602,563490,531360,1094850
"Manlleu","Demogràfic","Població assignada de 15-54 anys (n)",5743,5206,10949,2090135,2009939,4100074
"Manlleu","Demogràfic","Població assignada de 55-64 anys (n)",1426,1372,2798,485653,501618,987271
"Manlleu","Demogràfic","Població assignada de 65 anys o més (n)",1674,2118,3792,631736,839322,1471058
"Manlleu","Demogràfic","Població assignada total (n)",10696,10445,21141,3771014,3882239,7653253
"Manresa 01","Demogràfic","Població assignada de 0-14 anys (n)",1656,1558,3214,563490,531360,1094850
"Manresa 01","Demogràfic","Població assignada de 15-54 anys (n)",5614,5061,10675,2090135,2009939,4100074
"Manresa 01","Demogràfic","Població assignada de 55-64 anys (n)",1245,1152,2397,485653,501618,987271
"Manresa 01","Demogràfic","Població assignada de 65 anys o més (n)",1515,2154,3669,631736,839322,1471058
"Manresa 01","Demogràfic","Població assignada total (n)",10030,9925,19955,3771014,3882239,7653253
"Manresa 02 - Plaça Catalunya","Demogràfic","Població assignada de 0-14 anys (n)",1869,1713,3582,563490,531360,1094850
"Manresa 02 - Plaça Catalunya","Demogràfic","Població assignada de 15-54 anys (n)",6170,6075,12245,2090135,2009939,4100074
"Manresa 02 - Plaça Catalunya","Demogràfic","Població assignada de 55-64 anys (n)",1530,1596,3126,485653,501618,987271
"Manresa 02 - Plaça Catalunya","Demogràfic","Població assignada de 65 anys o més (n)",2018,2828,4846,631736,839322,1471058
"Manresa 02 - Plaça Catalunya","Demogràfic","Població assignada total (n)",11587,12212,23799,3771014,3882239,7653253
"Manresa 03","Demogràfic","Població assignada de 0-14 anys (n)",1409,1317,2726,563490,531360,1094850
"Manresa 03","Demogràfic","Població assignada de 15-54 anys (n)",4291,4080,8371,2090135,2009939,4100074
"Manresa 03","Demogràfic","Població assignada de 55-64 anys (n)",1043,1150,2193,485653,501618,987271
"Manresa 03","Demogràfic","Població assignada de 65 anys o més (n)",1425,1767,3192,631736,839322,1471058
"Manresa 03","Demogràfic","Població assignada total (n)",8168,8314,16482,3771014,3882239,7653253
"Manresa 04 - Sagrada Família","Demogràfic","Població assignada de 0-14 anys (n)",1781,1632,3413,563490,531360,1094850
"Manresa 04 - Sagrada Família","Demogràfic","Població assignada de 15-54 anys (n)",6114,5914,12028,2090135,2009939,4100074
"Manresa 04 - Sagrada Família","Demogràfic","Població assignada de 55-64 anys (n)",1514,1533,3047,485653,501618,987271
"Manresa 04 - Sagrada Família","Demogràfic","Població assignada de 65 anys o més (n)",1914,2590,4504,631736,839322,1471058
"Manresa 04 - Sagrada Família","Demogràfic","Població assignada total (n)",11323,11669,22992,3771014,3882239,7653253
"Martorell Rural","Demogràfic","Població assignada de 0-14 anys (n)",2091,2000,4091,563490,531360,1094850
"Martorell Rural","Demogràfic","Població assignada de 15-54 anys (n)",7572,7133,14705,2090135,2009939,4100074
"Martorell Rural","Demogràfic","Població assignada de 55-64 anys (n)",1770,1606,3376,485653,501618,987271
"Martorell Rural","Demogràfic","Població assignada de 65 anys o més (n)",1932,2333,4265,631736,839322,1471058
"Martorell Rural","Demogràfic","Població assignada total (n)",13365,13072,26437,3771014,3882239,7653253
"Martorell Urbà","Demogràfic","Població assignada de 0-14 anys (n)",2444,2298,4742,563490,531360,1094850
"Martorell Urbà","Demogràfic","Població assignada de 15-54 anys (n)",9090,8037,17127,2090135,2009939,4100074
"Martorell Urbà","Demogràfic","Població assignada de 55-64 anys (n)",1955,1805,3760,485653,501618,987271
"Martorell Urbà","Demogràfic","Població assignada de 65 anys o més (n)",2217,2837,5054,631736,839322,1471058
"Martorell Urbà","Demogràfic","Població assignada total (n)",15706,14977,30683,3771014,3882239,7653253
"Martorelles","Demogràfic","Població assignada de 0-14 anys (n)",991,936,1927,563490,531360,1094850
"Martorelles","Demogràfic","Població assignada de 15-54 anys (n)",3912,3619,7531,2090135,2009939,4100074
"Martorelles","Demogràfic","Població assignada de 55-64 anys (n)",978,998,1976,485653,501618,987271
"Martorelles","Demogràfic","Població assignada de 65 anys o més (n)",1342,1640,2982,631736,839322,1471058
"Martorelles","Demogràfic","Població assignada total (n)",7223,7193,14416,3771014,3882239,7653253
"Mataró 01 - La Riera","Demogràfic","Població assignada de 0-14 anys (n)",1340,1284,2624,563490,531360,1094850
"Mataró 01 - La Riera","Demogràfic","Població assignada de 15-54 anys (n)",4796,4984,9780,2090135,2009939,4100074
"Mataró 01 - La Riera","Demogràfic","Població assignada de 55-64 anys (n)",1211,1410,2621,485653,501618,987271
"Mataró 01 - La Riera","Demogràfic","Població assignada de 65 anys o més (n)",1610,2344,3954,631736,839322,1471058
"Mataró 01 - La Riera","Demogràfic","Població assignada total (n)",8957,10022,18979,3771014,3882239,7653253
"Mataró 02 - Centre","Demogràfic","Població assignada de 0-14 anys (n)",1469,1380,2849,563490,531360,1094850
"Mataró 02 - Centre","Demogràfic","Població assignada de 15-54 anys (n)",4774,4906,9680,2090135,2009939,4100074
"Mataró 02 - Centre","Demogràfic","Població assignada de 55-64 anys (n)",1160,1194,2354,485653,501618,987271
"Mataró 02 - Centre","Demogràfic","Població assignada de 65 anys o més (n)",1333,1797,3130,631736,839322,1471058
"Mataró 02 - Centre","Demogràfic","Població assignada total (n)",8736,9277,18013,3771014,3882239,7653253
"Mataró 03 - Rocafonda","Demogràfic","Població assignada de 0-14 anys (n)",1564,1466,3030,563490,531360,1094850
"Mataró 03 - Rocafonda","Demogràfic","Població assignada de 15-54 anys (n)",5682,4353,10035,2090135,2009939,4100074
"Mataró 03 - Rocafonda","Demogràfic","Població assignada de 55-64 anys (n)",1101,1053,2154,485653,501618,987271
"Mataró 03 - Rocafonda","Demogràfic","Població assignada de 65 anys o més (n)",1309,1762,3071,631736,839322,1471058
"Mataró 03 - Rocafonda","Demogràfic","Població assignada total (n)",9656,8634,18290,3771014,3882239,7653253
"Mataró 04 - Cirera Molins","Demogràfic","Població assignada de 0-14 anys (n)",1743,1677,3420,563490,531360,1094850
"Mataró 04 - Cirera Molins","Demogràfic","Població assignada de 15-54 anys (n)",5998,5770,11768,2090135,2009939,4100074
"Mataró 04 - Cirera Molins","Demogràfic","Població assignada de 55-64 anys (n)",1367,1388,2755,485653,501618,987271
"Mataró 04 - Cirera Molins","Demogràfic","Població assignada de 65 anys o més (n)",1734,2185,3919,631736,839322,1471058
"Mataró 04 - Cirera Molins","Demogràfic","Població assignada total (n)",10842,11020,21862,3771014,3882239,7653253
"Mataró 05 - Ronda Cerdanya","Demogràfic","Població assignada de 0-14 anys (n)",1548,1472,3020,563490,531360,1094850
"Mataró 05 - Ronda Cerdanya","Demogràfic","Població assignada de 15-54 anys (n)",5756,5251,11007,2090135,2009939,4100074
"Mataró 05 - Ronda Cerdanya","Demogràfic","Població assignada de 55-64 anys (n)",1281,1322,2603,485653,501618,987271
"Mataró 05 - Ronda Cerdanya","Demogràfic","Població assignada de 65 anys o més (n)",1462,1895,3357,631736,839322,1471058
"Mataró 05 - Ronda Cerdanya","Demogràfic","Població assignada total (n)",10047,9940,19987,3771014,3882239,7653253
"Mataró 06 - Ronda Gatassa","Demogràfic","Població assignada de 0-14 anys (n)",1260,1178,2438,563490,531360,1094850
"Mataró 06 - Ronda Gatassa","Demogràfic","Població assignada de 15-54 anys (n)",4679,3843,8522,2090135,2009939,4100074
"Mataró 06 - Ronda Gatassa","Demogràfic","Població assignada de 55-64 anys (n)",1004,902,1906,485653,501618,987271
"Mataró 06 - Ronda Gatassa","Demogràfic","Població assignada de 65 anys o més (n)",1076,1472,2548,631736,839322,1471058
"Mataró 06 - Ronda Gatassa","Demogràfic","Població assignada total (n)",8019,7395,15414,3771014,3882239,7653253
"Mataró 07 - Ronda Prim","Demogràfic","Població assignada de 0-14 anys (n)",1124,1031,2155,563490,531360,1094850
"Mataró 07 - Ronda Prim","Demogràfic","Població assignada de 15-54 anys (n)",4370,4186,8556,2090135,2009939,4100074
"Mataró 07 - Ronda Prim","Demogràfic","Població assignada de 55-64 anys (n)",1042,1243,2285,485653,501618,987271
"Mataró 07 - Ronda Prim","Demogràfic","Població assignada de 65 anys o més (n)",1422,1975,3397,631736,839322,1471058
"Mataró 07 - Ronda Prim","Demogràfic","Població assignada total (n)",7958,8435,16393,3771014,3882239,7653253
"Moià","Demogràfic","Població assignada de 0-14 anys (n)",759,746,1505,563490,531360,1094850
"Moià","Demogràfic","Població assignada de 15-54 anys (n)",2896,2516,5412,2090135,2009939,4100074
"Moià","Demogràfic","Població assignada de 55-64 anys (n)",713,677,1390,485653,501618,987271
"Moià","Demogràfic","Població assignada de 65 anys o més (n)",931,1160,2091,631736,839322,1471058
"Moià","Demogràfic","Població assignada total (n)",5299,5099,10398,3771014,3882239,7653253
"Molins de Rei","Demogràfic","Població assignada de 0-14 anys (n)",2441,2247,4688,563490,531360,1094850
"Molins de Rei","Demogràfic","Població assignada de 15-54 anys (n)",8046,7936,15982,2090135,2009939,4100074
"Molins de Rei","Demogràfic","Població assignada de 55-64 anys (n)",1878,1941,3819,485653,501618,987271
"Molins de Rei","Demogràfic","Població assignada de 65 anys o més (n)",2286,2990,5276,631736,839322,1471058
"Molins de Rei","Demogràfic","Població assignada total (n)",14651,15114,29765,3771014,3882239,7653253
"Mollet del Vallès 01 - Est","Demogràfic","Població assignada de 0-14 anys (n)",1956,1855,3811,563490,531360,1094850
"Mollet del Vallès 01 - Est","Demogràfic","Població assignada de 15-54 anys (n)",7562,7361,14923,2090135,2009939,4100074
"Mollet del Vallès 01 - Est","Demogràfic","Població assignada de 55-64 anys (n)",1835,1945,3780,485653,501618,987271
"Mollet del Vallès 01 - Est","Demogràfic","Població assignada de 65 anys o més (n)",2372,3087,5459,631736,839322,1471058
"Mollet del Vallès 01 - Est","Demogràfic","Població assignada total (n)",13725,14248,27973,3771014,3882239,7653253
"Mollet del Vallès 02 - Oest","Demogràfic","Població assignada de 0-14 anys (n)",1817,1611,3428,563490,531360,1094850
"Mollet del Vallès 02 - Oest","Demogràfic","Població assignada de 15-54 anys (n)",6817,6647,13464,2090135,2009939,4100074
"Mollet del Vallès 02 - Oest","Demogràfic","Població assignada de 55-64 anys (n)",1548,1474,3022,485653,501618,987271
"Mollet del Vallès 02 - Oest","Demogràfic","Població assignada de 65 anys o més (n)",1688,2147,3835,631736,839322,1471058
"Mollet del Vallès 02 - Oest","Demogràfic","Població assignada total (n)",11870,11879,23749,3771014,3882239,7653253
"Montblanc","Demogràfic","Població assignada de 0-14 anys (n)",1097,1025,2122,563490,531360,1094850
"Montblanc","Demogràfic","Població assignada de 15-54 anys (n)",4148,3685,7833,2090135,2009939,4100074
"Montblanc","Demogràfic","Població assignada de 55-64 anys (n)",1183,1034,2217,485653,501618,987271
"Montblanc","Demogràfic","Població assignada de 65 anys o més (n)",1506,1872,3378,631736,839322,1471058
"Montblanc","Demogràfic","Població assignada total (n)",7934,7616,15550,3771014,3882239,7653253
"Montcada i Reixac","Demogràfic","Població assignada de 0-14 anys (n)",2711,2569,5280,563490,531360,1094850
"Montcada i Reixac","Demogràfic","Població assignada de 15-54 anys (n)",9198,8845,18043,2090135,2009939,4100074
"Montcada i Reixac","Demogràfic","Població assignada de 55-64 anys (n)",2154,2117,4271,485653,501618,987271
"Montcada i Reixac","Demogràfic","Població assignada de 65 anys o més (n)",2327,3096,5423,631736,839322,1471058
"Montcada i Reixac","Demogràfic","Població assignada total (n)",16390,16627,33017,3771014,3882239,7653253
"Montgat - Tiana","Demogràfic","Població assignada de 0-14 anys (n)",1679,1575,3254,563490,531360,1094850
"Montgat - Tiana","Demogràfic","Població assignada de 15-54 anys (n)",5356,5391,10747,2090135,2009939,4100074
"Montgat - Tiana","Demogràfic","Població assignada de 55-64 anys (n)",1233,1328,2561,485653,501618,987271
"Montgat - Tiana","Demogràfic","Població assignada de 65 anys o més (n)",1560,1953,3513,631736,839322,1471058
"Montgat - Tiana","Demogràfic","Població assignada total (n)",9828,10247,20075,3771014,3882239,7653253
"Montornès del Vallès - Montmeló","Demogràfic","Població assignada de 0-14 anys (n)",2676,2550,5226,563490,531360,1094850
"Montornès del Vallès - Montmeló","Demogràfic","Població assignada de 15-54 anys (n)",9291,8814,18105,2090135,2009939,4100074
"Montornès del Vallès - Montmeló","Demogràfic","Població assignada de 55-64 anys (n)",2156,2061,4217,485653,501618,987271
"Montornès del Vallès - Montmeló","Demogràfic","Població assignada de 65 anys o més (n)",2490,3021,5511,631736,839322,1471058
"Montornès del Vallès - Montmeló","Demogràfic","Població assignada total (n)",16613,16446,33059,3771014,3882239,7653253
"Mont-roig del Camp","Demogràfic","Població assignada de 0-14 anys (n)",1109,973,2082,563490,531360,1094850
"Mont-roig del Camp","Demogràfic","Població assignada de 15-54 anys (n)",3548,3328,6876,2090135,2009939,4100074
"Mont-roig del Camp","Demogràfic","Població assignada de 55-64 anys (n)",907,859,1766,485653,501618,987271
"Mont-roig del Camp","Demogràfic","Població assignada de 65 anys o més (n)",1236,1288,2524,631736,839322,1471058
"Mont-roig del Camp","Demogràfic","Població assignada total (n)",6800,6448,13248,3771014,3882239,7653253
"Montserrat","Demogràfic","Població assignada de 0-14 anys (n)",1034,953,1987,563490,531360,1094850
"Montserrat","Demogràfic","Població assignada de 15-54 anys (n)",3729,3386,7115,2090135,2009939,4100074
"Montserrat","Demogràfic","Població assignada de 55-64 anys (n)",766,701,1467,485653,501618,987271
"Montserrat","Demogràfic","Població assignada de 65 anys o més (n)",999,1152,2151,631736,839322,1471058
"Montserrat","Demogràfic","Població assignada total (n)",6528,6192,12720,3771014,3882239,7653253
"Móra la Nova - Móra d'Ebre","Demogràfic","Població assignada de 0-14 anys (n)",972,865,1837,563490,531360,1094850
"Móra la Nova - Móra d'Ebre","Demogràfic","Població assignada de 15-54 anys (n)",3542,3126,6668,2090135,2009939,4100074
"Móra la Nova - Móra d'Ebre","Demogràfic","Població assignada de 55-64 anys (n)",1043,1010,2053,485653,501618,987271
"Móra la Nova - Móra d'Ebre","Demogràfic","Població assignada de 65 anys o més (n)",1488,1786,3274,631736,839322,1471058
"Móra la Nova - Móra d'Ebre","Demogràfic","Població assignada total (n)",7045,6787,13832,3771014,3882239,7653253
"Navarcles - Sant Fruitós de Bages","Demogràfic","Població assignada de 0-14 anys (n)",1780,1721,3501,563490,531360,1094850
"Navarcles - Sant Fruitós de Bages","Demogràfic","Població assignada de 15-54 anys (n)",5860,5659,11519,2090135,2009939,4100074
"Navarcles - Sant Fruitós de Bages","Demogràfic","Població assignada de 55-64 anys (n)",1497,1464,2961,485653,501618,987271
"Navarcles - Sant Fruitós de Bages","Demogràfic","Població assignada de 65 anys o més (n)",1927,2425,4352,631736,839322,1471058
"Navarcles - Sant Fruitós de Bages","Demogràfic","Població assignada total (n)",11064,11269,22333,3771014,3882239,7653253
"Navàs - Balsareny","Demogràfic","Població assignada de 0-14 anys (n)",615,642,1257,563490,531360,1094850
"Navàs - Balsareny","Demogràfic","Població assignada de 15-54 anys (n)",2374,2201,4575,2090135,2009939,4100074
"Navàs - Balsareny","Demogràfic","Població assignada de 55-64 anys (n)",760,704,1464,485653,501618,987271
"Navàs - Balsareny","Demogràfic","Població assignada de 65 anys o més (n)",940,1214,2154,631736,839322,1471058
"Navàs - Balsareny","Demogràfic","Població assignada total (n)",4689,4761,9450,3771014,3882239,7653253
"Ocata - Teià","Demogràfic","Població assignada de 0-14 anys (n)",31,39,70,563490,531360,1094850
"Ocata - Teià","Demogràfic","Població assignada de 15-54 anys (n)",3767,3741,7508,2090135,2009939,4100074
"Ocata - Teià","Demogràfic","Població assignada de 55-64 anys (n)",1028,1144,2172,485653,501618,987271
"Ocata - Teià","Demogràfic","Població assignada de 65 anys o més (n)",1329,1786,3115,631736,839322,1471058
"Ocata - Teià","Demogràfic","Població assignada total (n)",6155,6710,12865,3771014,3882239,7653253
"Olesa de Montserrat","Demogràfic","Població assignada de 0-14 anys (n)",1984,1938,3922,563490,531360,1094850
"Olesa de Montserrat","Demogràfic","Població assignada de 15-54 anys (n)",6869,6470,13339,2090135,2009939,4100074
"Olesa de Montserrat","Demogràfic","Població assignada de 55-64 anys (n)",1407,1384,2791,485653,501618,987271
"Olesa de Montserrat","Demogràfic","Població assignada de 65 anys o més (n)",1774,2251,4025,631736,839322,1471058
"Olesa de Montserrat","Demogràfic","Població assignada total (n)",12034,12043,24077,3771014,3882239,7653253
"Olot","Demogràfic","Població assignada de 0-14 anys (n)",2910,2714,5624,563490,531360,1094850
"Olot","Demogràfic","Població assignada de 15-54 anys (n)",11132,9975,21107,2090135,2009939,4100074
"Olot","Demogràfic","Població assignada de 55-64 anys (n)",2790,2664,5454,485653,501618,987271
"Olot","Demogràfic","Població assignada de 65 anys o més (n)",3483,4484,7967,631736,839322,1471058
"Olot","Demogràfic","Població assignada total (n)",20315,19837,40152,3771014,3882239,7653253
"Palafrugell","Demogràfic","Població assignada de 0-14 anys (n)",2516,2247,4763,563490,531360,1094850
"Palafrugell","Demogràfic","Població assignada de 15-54 anys (n)",8048,7685,15733,2090135,2009939,4100074
"Palafrugell","Demogràfic","Població assignada de 55-64 anys (n)",2084,2125,4209,485653,501618,987271
"Palafrugell","Demogràfic","Població assignada de 65 anys o més (n)",2665,3215,5880,631736,839322,1471058
"Palafrugell","Demogràfic","Població assignada total (n)",15313,15272,30585,3771014,3882239,7653253
"Palamós","Demogràfic","Població assignada de 0-14 anys (n)",2089,1915,4004,563490,531360,1094850
"Palamós","Demogràfic","Població assignada de 15-54 anys (n)",7563,7381,14944,2090135,2009939,4100074
"Palamós","Demogràfic","Població assignada de 55-64 anys (n)",1994,2120,4114,485653,501618,987271
"Palamós","Demogràfic","Població assignada de 65 anys o més (n)",2627,3345,5972,631736,839322,1471058
"Palamós","Demogràfic","Població assignada total (n)",14273,14761,29034,3771014,3882239,7653253
"Palau-solità i Plegamans","Demogràfic","Població assignada de 0-14 anys (n)",1066,1100,2166,563490,531360,1094850
"Palau-solità i Plegamans","Demogràfic","Població assignada de 15-54 anys (n)",4194,4082,8276,2090135,2009939,4100074
"Palau-solità i Plegamans","Demogràfic","Població assignada de 55-64 anys (n)",1020,1047,2067,485653,501618,987271
"Palau-solità i Plegamans","Demogràfic","Població assignada de 65 anys o més (n)",1220,1471,2691,631736,839322,1471058
"Palau-solità i Plegamans","Demogràfic","Població assignada total (n)",7500,7700,15200,3771014,3882239,7653253
"Pallars Sobirà","Demogràfic","Població assignada de 0-14 anys (n)",433,406,839,563490,531360,1094850
"Pallars Sobirà","Demogràfic","Població assignada de 15-54 anys (n)",1659,1556,3215,2090135,2009939,4100074
"Pallars Sobirà","Demogràfic","Població assignada de 55-64 anys (n)",473,413,886,485653,501618,987271
"Pallars Sobirà","Demogràfic","Població assignada de 65 anys o més (n)",552,638,1190,631736,839322,1471058
"Pallars Sobirà","Demogràfic","Població assignada total (n)",3117,3013,6130,3771014,3882239,7653253
"Pallejà","Demogràfic","Població assignada de 0-14 anys (n)",949,829,1778,563490,531360,1094850
"Pallejà","Demogràfic","Població assignada de 15-54 anys (n)",3050,2963,6013,2090135,2009939,4100074
"Pallejà","Demogràfic","Població assignada de 55-64 anys (n)",690,672,1362,485653,501618,987271
"Pallejà","Demogràfic","Població assignada de 65 anys o més (n)",758,995,1753,631736,839322,1471058
"Pallejà","Demogràfic","Població assignada total (n)",5447,5459,10906,3771014,3882239,7653253
"Parets del Vallès","Demogràfic","Població assignada de 0-14 anys (n)",1511,1407,2918,563490,531360,1094850
"Parets del Vallès","Demogràfic","Població assignada de 15-54 anys (n)",5262,5002,10264,2090135,2009939,4100074
"Parets del Vallès","Demogràfic","Població assignada de 55-64 anys (n)",1223,1191,2414,485653,501618,987271
"Parets del Vallès","Demogràfic","Població assignada de 65 anys o més (n)",1393,1720,3113,631736,839322,1471058
"Parets del Vallès","Demogràfic","Població assignada total (n)",9389,9320,18709,3771014,3882239,7653253
"Penedès Rural","Demogràfic","Població assignada de 0-14 anys (n)",1068,963,2031,563490,531360,1094850
"Penedès Rural","Demogràfic","Població assignada de 15-54 anys (n)",8248,7501,15749,2090135,2009939,4100074
"Penedès Rural","Demogràfic","Població assignada de 55-64 anys (n)",2285,2037,4322,485653,501618,987271
"Penedès Rural","Demogràfic","Població assignada de 65 anys o més (n)",2961,3312,6273,631736,839322,1471058
"Penedès Rural","Demogràfic","Població assignada total (n)",14562,13813,28375,3771014,3882239,7653253
"Peralada","Demogràfic","Població assignada de 0-14 anys (n)",520,493,1013,563490,531360,1094850
"Peralada","Demogràfic","Població assignada de 15-54 anys (n)",1912,1816,3728,2090135,2009939,4100074
"Peralada","Demogràfic","Població assignada de 55-64 anys (n)",508,488,996,485653,501618,987271
"Peralada","Demogràfic","Població assignada de 65 anys o més (n)",753,817,1570,631736,839322,1471058
"Peralada","Demogràfic","Població assignada total (n)",3693,3614,7307,3771014,3882239,7653253
"Piera","Demogràfic","Població assignada de 0-14 anys (n)",1480,1402,2882,563490,531360,1094850
"Piera","Demogràfic","Població assignada de 15-54 anys (n)",5271,4722,9993,2090135,2009939,4100074
"Piera","Demogràfic","Població assignada de 55-64 anys (n)",1108,1076,2184,485653,501618,987271
"Piera","Demogràfic","Població assignada de 65 anys o més (n)",1354,1687,3041,631736,839322,1471058
"Piera","Demogràfic","Població assignada total (n)",9213,8887,18100,3771014,3882239,7653253
"Pineda de Mar","Demogràfic","Població assignada de 0-14 anys (n)",2123,2117,4240,563490,531360,1094850
"Pineda de Mar","Demogràfic","Població assignada de 15-54 anys (n)",8197,7569,15766,2090135,2009939,4100074
"Pineda de Mar","Demogràfic","Població assignada de 55-64 anys (n)",2025,2002,4027,485653,501618,987271
"Pineda de Mar","Demogràfic","Població assignada de 65 anys o més (n)",2867,3515,6382,631736,839322,1471058
"Pineda de Mar","Demogràfic","Població assignada total (n)",15212,15203,30415,3771014,3882239,7653253
"Pla d'Urgell","Demogràfic","Població assignada de 0-14 anys (n)",3002,2885,5887,563490,531360,1094850
"Pla d'Urgell","Demogràfic","Població assignada de 15-54 anys (n)",10511,9018,19529,2090135,2009939,4100074
"Pla d'Urgell","Demogràfic","Població assignada de 55-64 anys (n)",2632,2295,4927,485653,501618,987271
"Pla d'Urgell","Demogràfic","Població assignada de 65 anys o més (n)",3251,4001,7252,631736,839322,1471058
"Pla d'Urgell","Demogràfic","Població assignada total (n)",19396,18199,37595,3771014,3882239,7653253
"Polinyà - Sentmenat","Demogràfic","Població assignada de 0-14 anys (n)",1451,1472,2923,563490,531360,1094850
"Polinyà - Sentmenat","Demogràfic","Població assignada de 15-54 anys (n)",4855,4542,9397,2090135,2009939,4100074
"Polinyà - Sentmenat","Demogràfic","Població assignada de 55-64 anys (n)",983,934,1917,485653,501618,987271
"Polinyà - Sentmenat","Demogràfic","Població assignada de 65 anys o més (n)",1089,1272,2361,631736,839322,1471058
"Polinyà - Sentmenat","Demogràfic","Població assignada total (n)",8378,8220,16598,3771014,3882239,7653253
"Ponts","Demogràfic","Població assignada de 0-14 anys (n)",234,217,451,563490,531360,1094850
"Ponts","Demogràfic","Població assignada de 15-54 anys (n)",948,771,1719,2090135,2009939,4100074
"Ponts","Demogràfic","Població assignada de 55-64 anys (n)",248,238,486,485653,501618,987271
"Ponts","Demogràfic","Població assignada de 65 anys o més (n)",406,478,884,631736,839322,1471058
"Ponts","Demogràfic","Població assignada total (n)",1836,1704,3540,3771014,3882239,7653253
"Premià de Mar","Demogràfic","Població assignada de 0-14 anys (n)",2740,2589,5329,563490,531360,1094850
"Premià de Mar","Demogràfic","Població assignada de 15-54 anys (n)",10040,9601,19641,2090135,2009939,4100074
"Premià de Mar","Demogràfic","Població assignada de 55-64 anys (n)",2573,2738,5311,485653,501618,987271
"Premià de Mar","Demogràfic","Població assignada de 65 anys o més (n)",3321,4449,7770,631736,839322,1471058
"Premià de Mar","Demogràfic","Població assignada total (n)",18674,19377,38051,3771014,3882239,7653253
"Reus 01 - Sant Pere","Demogràfic","Població assignada de 0-14 anys (n)",672,643,1315,563490,531360,1094850
"Reus 01 - Sant Pere","Demogràfic","Població assignada de 15-54 anys (n)",3756,3718,7474,2090135,2009939,4100074
"Reus 01 - Sant Pere","Demogràfic","Població assignada de 55-64 anys (n)",815,792,1607,485653,501618,987271
"Reus 01 - Sant Pere","Demogràfic","Població assignada de 65 anys o més (n)",993,1383,2376,631736,839322,1471058
"Reus 01 - Sant Pere","Demogràfic","Població assignada total (n)",6236,6536,12772,3771014,3882239,7653253
"Reus 02 - Sant Pere","Demogràfic","Població assignada de 0-14 anys (n)",2300,2207,4507,563490,531360,1094850
"Reus 02 - Sant Pere","Demogràfic","Població assignada de 15-54 anys (n)",7311,7402,14713,2090135,2009939,4100074
"Reus 02 - Sant Pere","Demogràfic","Població assignada de 55-64 anys (n)",1806,1973,3779,485653,501618,987271
"Reus 02 - Sant Pere","Demogràfic","Població assignada de 65 anys o més (n)",2501,3268,5769,631736,839322,1471058
"Reus 02 - Sant Pere","Demogràfic","Població assignada total (n)",13918,14850,28768,3771014,3882239,7653253
"Reus 03 - Llibertat","Demogràfic","Població assignada de 0-14 anys (n)",1600,1418,3018,563490,531360,1094850
"Reus 03 - Llibertat","Demogràfic","Població assignada de 15-54 anys (n)",5479,5482,10961,2090135,2009939,4100074
"Reus 03 - Llibertat","Demogràfic","Població assignada de 55-64 anys (n)",1459,1591,3050,485653,501618,987271
"Reus 03 - Llibertat","Demogràfic","Població assignada de 65 anys o més (n)",1961,2534,4495,631736,839322,1471058
"Reus 03 - Llibertat","Demogràfic","Població assignada total (n)",10499,11025,21524,3771014,3882239,7653253
"Reus 04 - Horts de Miró","Demogràfic","Població assignada de 0-14 anys (n)",1719,1688,3407,563490,531360,1094850
"Reus 04 - Horts de Miró","Demogràfic","Població assignada de 15-54 anys (n)",5720,5541,11261,2090135,2009939,4100074
"Reus 04 - Horts de Miró","Demogràfic","Població assignada de 55-64 anys (n)",1267,1281,2548,485653,501618,987271
"Reus 04 - Horts de Miró","Demogràfic","Població assignada de 65 anys o més (n)",1500,1852,3352,631736,839322,1471058
"Reus 04 - Horts de Miró","Demogràfic","Població assignada total (n)",10206,10362,20568,3771014,3882239,7653253
"Reus 05 - Barri Fortuny","Demogràfic","Població assignada de 0-14 anys (n)",2632,2595,5227,563490,531360,1094850
"Reus 05 - Barri Fortuny","Demogràfic","Població assignada de 15-54 anys (n)",7846,7571,15417,2090135,2009939,4100074
"Reus 05 - Barri Fortuny","Demogràfic","Població assignada de 55-64 anys (n)",1789,1742,3531,485653,501618,987271
"Reus 05 - Barri Fortuny","Demogràfic","Població assignada de 65 anys o més (n)",1940,2578,4518,631736,839322,1471058
"Reus 05 - Barri Fortuny","Demogràfic","Població assignada total (n)",14207,14486,28693,3771014,3882239,7653253
"Ribes - Olivella","Demogràfic","Població assignada de 0-14 anys (n)",1346,1312,2658,563490,531360,1094850
"Ribes - Olivella","Demogràfic","Població assignada de 15-54 anys (n)",5022,4932,9954,2090135,2009939,4100074
"Ribes - Olivella","Demogràfic","Població assignada de 55-64 anys (n)",1239,1179,2418,485653,501618,987271
"Ribes - Olivella","Demogràfic","Població assignada de 65 anys o més (n)",1442,1720,3162,631736,839322,1471058
"Ribes - Olivella","Demogràfic","Població assignada total (n)",9049,9143,18192,3771014,3882239,7653253
"Ribes de Freser - Campdevànol","Demogràfic","Població assignada de 0-14 anys (n)",308,287,595,563490,531360,1094850
"Ribes de Freser - Campdevànol","Demogràfic","Població assignada de 15-54 anys (n)",1412,1250,2662,2090135,2009939,4100074
"Ribes de Freser - Campdevànol","Demogràfic","Població assignada de 55-64 anys (n)",438,425,863,485653,501618,987271
"Ribes de Freser - Campdevànol","Demogràfic","Població assignada de 65 anys o més (n)",696,875,1571,631736,839322,1471058
"Ribes de Freser - Campdevànol","Demogràfic","Població assignada total (n)",2854,2837,5691,3771014,3882239,7653253
"Ripoll - Sant Joan de les Abadesses","Demogràfic","Població assignada de 0-14 anys (n)",1001,951,1952,563490,531360,1094850
"Ripoll - Sant Joan de les Abadesses","Demogràfic","Població assignada de 15-54 anys (n)",3519,3169,6688,2090135,2009939,4100074
"Ripoll - Sant Joan de les Abadesses","Demogràfic","Població assignada de 55-64 anys (n)",1052,1090,2142,485653,501618,987271
"Ripoll - Sant Joan de les Abadesses","Demogràfic","Població assignada de 65 anys o més (n)",1561,1995,3556,631736,839322,1471058
"Ripoll - Sant Joan de les Abadesses","Demogràfic","Població assignada total (n)",7133,7205,14338,3771014,3882239,7653253
"Ripollet 01 - Centre","Demogràfic","Població assignada de 0-14 anys (n)",2981,2831,5812,563490,531360,1094850
"Ripollet 01 - Centre","Demogràfic","Població assignada de 15-54 anys (n)",5043,4819,9862,2090135,2009939,4100074
"Ripollet 01 - Centre","Demogràfic","Població assignada de 55-64 anys (n)",1119,1094,2213,485653,501618,987271
"Ripollet 01 - Centre","Demogràfic","Població assignada de 65 anys o més (n)",1369,1850,3219,631736,839322,1471058
"Ripollet 01 - Centre","Demogràfic","Població assignada total (n)",10512,10594,21106,3771014,3882239,7653253
"Ripollet 02 - Pinetons","Demogràfic","Població assignada de 0-14 anys (n)",23,14,37,563490,531360,1094850
"Ripollet 02 - Pinetons","Demogràfic","Població assignada de 15-54 anys (n)",4188,4209,8397,2090135,2009939,4100074
"Ripollet 02 - Pinetons","Demogràfic","Població assignada de 55-64 anys (n)",928,926,1854,485653,501618,987271
"Ripollet 02 - Pinetons","Demogràfic","Població assignada de 65 anys o més (n)",946,1179,2125,631736,839322,1471058
"Ripollet 02 - Pinetons","Demogràfic","Població assignada total (n)",6085,6328,12413,3771014,3882239,7653253
"Riudoms","Demogràfic","Població assignada de 0-14 anys (n)",1104,945,2049,563490,531360,1094850
"Riudoms","Demogràfic","Població assignada de 15-54 anys (n)",3313,2933,6246,2090135,2009939,4100074
"Riudoms","Demogràfic","Població assignada de 55-64 anys (n)",796,749,1545,485653,501618,987271
"Riudoms","Demogràfic","Població assignada de 65 anys o més (n)",1111,1252,2363,631736,839322,1471058
"Riudoms","Demogràfic","Població assignada total (n)",6324,5879,12203,3771014,3882239,7653253
"Roda de Ter","Demogràfic","Població assignada de 0-14 anys (n)",663,649,1312,563490,531360,1094850
"Roda de Ter","Demogràfic","Població assignada de 15-54 anys (n)",2446,2253,4699,2090135,2009939,4100074
"Roda de Ter","Demogràfic","Població assignada de 55-64 anys (n)",691,658,1349,485653,501618,987271
"Roda de Ter","Demogràfic","Població assignada de 65 anys o més (n)",888,1140,2028,631736,839322,1471058
"Roda de Ter","Demogràfic","Població assignada total (n)",4688,4700,9388,3771014,3882239,7653253
"Roses","Demogràfic","Població assignada de 0-14 anys (n)",2568,2407,4975,563490,531360,1094850
"Roses","Demogràfic","Població assignada de 15-54 anys (n)",9167,8799,17966,2090135,2009939,4100074
"Roses","Demogràfic","Població assignada de 55-64 anys (n)",2372,2229,4601,485653,501618,987271
"Roses","Demogràfic","Població assignada de 65 anys o més (n)",2714,3357,6071,631736,839322,1471058
"Roses","Demogràfic","Població assignada total (n)",16821,16792,33613,3771014,3882239,7653253
"Rubí 01","Demogràfic","Població assignada de 0-14 anys (n)",2428,2388,4816,563490,531360,1094850
"Rubí 01","Demogràfic","Població assignada de 15-54 anys (n)",8861,8634,17495,2090135,2009939,4100074
"Rubí 01","Demogràfic","Població assignada de 55-64 anys (n)",2052,2039,4091,485653,501618,987271
"Rubí 01","Demogràfic","Població assignada de 65 anys o més (n)",2314,2994,5308,631736,839322,1471058
"Rubí 01","Demogràfic","Població assignada total (n)",15655,16055,31710,3771014,3882239,7653253
"Rubí 02 - Anton Borja","Demogràfic","Població assignada de 0-14 anys (n)",2329,2205,4534,563490,531360,1094850
"Rubí 02 - Anton Borja","Demogràfic","Població assignada de 15-54 anys (n)",8357,8207,16564,2090135,2009939,4100074
"Rubí 02 - Anton Borja","Demogràfic","Població assignada de 55-64 anys (n)",1775,1964,3739,485653,501618,987271
"Rubí 02 - Anton Borja","Demogràfic","Població assignada de 65 anys o més (n)",2246,2979,5225,631736,839322,1471058
"Rubí 02 - Anton Borja","Demogràfic","Població assignada total (n)",14707,15355,30062,3771014,3882239,7653253
"Rubí 03","Demogràfic","Població assignada de 0-14 anys (n)",1275,1254,2529,563490,531360,1094850
"Rubí 03","Demogràfic","Població assignada de 15-54 anys (n)",4365,4042,8407,2090135,2009939,4100074
"Rubí 03","Demogràfic","Població assignada de 55-64 anys (n)",994,953,1947,485653,501618,987271
"Rubí 03","Demogràfic","Població assignada de 65 anys o més (n)",1030,1202,2232,631736,839322,1471058
"Rubí 03","Demogràfic","Població assignada total (n)",7664,7451,15115,3771014,3882239,7653253
"Sabadell 01A - Centre","Demogràfic","Població assignada de 0-14 anys (n)",2828,2623,5451,563490,531360,1094850
"Sabadell 01A - Centre","Demogràfic","Població assignada de 15-54 anys (n)",8896,9317,18213,2090135,2009939,4100074
"Sabadell 01A - Centre","Demogràfic","Població assignada de 55-64 anys (n)",2202,2490,4692,485653,501618,987271
"Sabadell 01A - Centre","Demogràfic","Població assignada de 65 anys o més (n)",2934,4271,7205,631736,839322,1471058
"Sabadell 01A - Centre","Demogràfic","Població assignada total (n)",16860,18701,35561,3771014,3882239,7653253
"Sabadell 01B - Sant Oleguer","Demogràfic","Població assignada de 0-14 anys (n)",1439,1321,2760,563490,531360,1094850
"Sabadell 01B - Sant Oleguer","Demogràfic","Població assignada de 15-54 anys (n)",5322,5471,10793,2090135,2009939,4100074
"Sabadell 01B - Sant Oleguer","Demogràfic","Població assignada de 55-64 anys (n)",1295,1461,2756,485653,501618,987271
"Sabadell 01B - Sant Oleguer","Demogràfic","Població assignada de 65 anys o més (n)",1823,2658,4481,631736,839322,1471058
"Sabadell 01B - Sant Oleguer","Demogràfic","Població assignada total (n)",9879,10911,20790,3771014,3882239,7653253
"Sabadell 02 - Creu Alta","Demogràfic","Població assignada de 0-14 anys (n)",1748,1673,3421,563490,531360,1094850
"Sabadell 02 - Creu Alta","Demogràfic","Població assignada de 15-54 anys (n)",6008,5766,11774,2090135,2009939,4100074
"Sabadell 02 - Creu Alta","Demogràfic","Població assignada de 55-64 anys (n)",1443,1593,3036,485653,501618,987271
"Sabadell 02 - Creu Alta","Demogràfic","Població assignada de 65 anys o més (n)",1966,2659,4625,631736,839322,1471058
"Sabadell 02 - Creu Alta","Demogràfic","Població assignada total (n)",11165,11691,22856,3771014,3882239,7653253
"Sabadell 03A - Ca n'Oriac","Demogràfic","Població assignada de 0-14 anys (n)",1489,1408,2897,563490,531360,1094850
"Sabadell 03A - Ca n'Oriac","Demogràfic","Població assignada de 15-54 anys (n)",5597,5376,10973,2090135,2009939,4100074
"Sabadell 03A - Ca n'Oriac","Demogràfic","Població assignada de 55-64 anys (n)",1315,1392,2707,485653,501618,987271
"Sabadell 03A - Ca n'Oriac","Demogràfic","Població assignada de 65 anys o més (n)",1631,2222,3853,631736,839322,1471058
"Sabadell 03A - Ca n'Oriac","Demogràfic","Població assignada total (n)",10032,10398,20430,3771014,3882239,7653253
"Sabadell 03B - Nord","Demogràfic","Població assignada de 0-14 anys (n)",1255,1207,2462,563490,531360,1094850
"Sabadell 03B - Nord","Demogràfic","Població assignada de 15-54 anys (n)",4488,4411,8899,2090135,2009939,4100074
"Sabadell 03B - Nord","Demogràfic","Població assignada de 55-64 anys (n)",1009,1046,2055,485653,501618,987271
"Sabadell 03B - Nord","Demogràfic","Població assignada de 65 anys o més (n)",1284,1780,3064,631736,839322,1471058
"Sabadell 03B - Nord","Demogràfic","Població assignada total (n)",8036,8444,16480,3771014,3882239,7653253
"Sabadell 04A - Concòrdia","Demogràfic","Població assignada de 0-14 anys (n)",912,917,1829,563490,531360,1094850
"Sabadell 04A - Concòrdia","Demogràfic","Població assignada de 15-54 anys (n)",3631,3553,7184,2090135,2009939,4100074
"Sabadell 04A - Concòrdia","Demogràfic","Població assignada de 55-64 anys (n)",912,1065,1977,485653,501618,987271
"Sabadell 04A - Concòrdia","Demogràfic","Població assignada de 65 anys o més (n)",1380,1771,3151,631736,839322,1471058
"Sabadell 04A - Concòrdia","Demogràfic","Població assignada total (n)",6835,7306,14141,3771014,3882239,7653253
"Sabadell 04B - Can Rull","Demogràfic","Població assignada de 0-14 anys (n)",2049,1860,3909,563490,531360,1094850
"Sabadell 04B - Can Rull","Demogràfic","Població assignada de 15-54 anys (n)",6447,6310,12757,2090135,2009939,4100074
"Sabadell 04B - Can Rull","Demogràfic","Població assignada de 55-64 anys (n)",1324,1390,2714,485653,501618,987271
"Sabadell 04B - Can Rull","Demogràfic","Població assignada de 65 anys o més (n)",1796,2424,4220,631736,839322,1471058
"Sabadell 04B - Can Rull","Demogràfic","Població assignada total (n)",11616,11984,23600,3771014,3882239,7653253
"Sabadell 05 - Gràcia - Merinals","Demogràfic","Població assignada de 0-14 anys (n)",1433,1456,2889,563490,531360,1094850
"Sabadell 05 - Gràcia - Merinals","Demogràfic","Població assignada de 15-54 anys (n)",5397,5113,10510,2090135,2009939,4100074
"Sabadell 05 - Gràcia - Merinals","Demogràfic","Població assignada de 55-64 anys (n)",1194,1273,2467,485653,501618,987271
"Sabadell 05 - Gràcia - Merinals","Demogràfic","Població assignada de 65 anys o més (n)",1427,1873,3300,631736,839322,1471058
"Sabadell 05 - Gràcia - Merinals","Demogràfic","Població assignada total (n)",9451,9715,19166,3771014,3882239,7653253
"Sabadell 06 - Sud","Demogràfic","Població assignada de 0-14 anys (n)",2635,2460,5095,563490,531360,1094850
"Sabadell 06 - Sud","Demogràfic","Població assignada de 15-54 anys (n)",8888,8526,17414,2090135,2009939,4100074
"Sabadell 06 - Sud","Demogràfic","Població assignada de 55-64 anys (n)",2077,2139,4216,485653,501618,987271
"Sabadell 06 - Sud","Demogràfic","Població assignada de 65 anys o més (n)",2379,3415,5794,631736,839322,1471058
"Sabadell 06 - Sud","Demogràfic","Població assignada total (n)",15979,16540,32519,3771014,3882239,7653253
"Sabadell 07 - La Serra","Demogràfic","Població assignada de 0-14 anys (n)",877,851,1728,563490,531360,1094850
"Sabadell 07 - La Serra","Demogràfic","Població assignada de 15-54 anys (n)",2795,2578,5373,2090135,2009939,4100074
"Sabadell 07 - La Serra","Demogràfic","Població assignada de 55-64 anys (n)",560,546,1106,485653,501618,987271
"Sabadell 07 - La Serra","Demogràfic","Població assignada de 65 anys o més (n)",610,731,1341,631736,839322,1471058
"Sabadell 07 - La Serra","Demogràfic","Població assignada total (n)",4842,4706,9548,3771014,3882239,7653253
"Sallent","Demogràfic","Població assignada de 0-14 anys (n)",450,404,854,563490,531360,1094850
"Sallent","Demogràfic","Població assignada de 15-54 anys (n)",1631,1585,3216,2090135,2009939,4100074
"Sallent","Demogràfic","Població assignada de 55-64 anys (n)",442,463,905,485653,501618,987271
"Sallent","Demogràfic","Població assignada de 65 anys o més (n)",749,948,1697,631736,839322,1471058
"Sallent","Demogràfic","Població assignada total (n)",3272,3400,6672,3771014,3882239,7653253
"Salou","Demogràfic","Població assignada de 0-14 anys (n)",2218,2045,4263,563490,531360,1094850
"Salou","Demogràfic","Població assignada de 15-54 anys (n)",8268,7576,15844,2090135,2009939,4100074
"Salou","Demogràfic","Població assignada de 55-64 anys (n)",1759,1706,3465,485653,501618,987271
"Salou","Demogràfic","Població assignada de 65 anys o més (n)",1699,2041,3740,631736,839322,1471058
"Salou","Demogràfic","Població assignada total (n)",13944,13368,27312,3771014,3882239,7653253
"Salt","Demogràfic","Població assignada de 0-14 anys (n)",4199,3796,7995,563490,531360,1094850
"Salt","Demogràfic","Població assignada de 15-54 anys (n)",12799,10911,23710,2090135,2009939,4100074
"Salt","Demogràfic","Població assignada de 55-64 anys (n)",2514,2292,4806,485653,501618,987271
"Salt","Demogràfic","Població assignada de 65 anys o més (n)",2581,3206,5787,631736,839322,1471058
"Salt","Demogràfic","Població assignada total (n)",22093,20205,42298,3771014,3882239,7653253
"Sant Adrià de Besòs 01 - Dr. Barraquer","Demogràfic","Població assignada de 0-14 anys (n)",1749,1635,3384,563490,531360,1094850
"Sant Adrià de Besòs 01 - Dr. Barraquer","Demogràfic","Població assignada de 15-54 anys (n)",6205,6137,12342,2090135,2009939,4100074
"Sant Adrià de Besòs 01 - Dr. Barraquer","Demogràfic","Població assignada de 55-64 anys (n)",1427,1578,3005,485653,501618,987271
"Sant Adrià de Besòs 01 - Dr. Barraquer","Demogràfic","Població assignada de 65 anys o més (n)",1847,2566,4413,631736,839322,1471058
"Sant Adrià de Besòs 01 - Dr. Barraquer","Demogràfic","Població assignada total (n)",11228,11916,23144,3771014,3882239,7653253
"Sant Adrià de Besòs 02 - La Mina","Demogràfic","Població assignada de 0-14 anys (n)",1496,1422,2918,563490,531360,1094850
"Sant Adrià de Besòs 02 - La Mina","Demogràfic","Població assignada de 15-54 anys (n)",4794,4279,9073,2090135,2009939,4100074
"Sant Adrià de Besòs 02 - La Mina","Demogràfic","Població assignada de 55-64 anys (n)",989,904,1893,485653,501618,987271
"Sant Adrià de Besòs 02 - La Mina","Demogràfic","Població assignada de 65 anys o més (n)",945,1430,2375,631736,839322,1471058
"Sant Adrià de Besòs 02 - La Mina","Demogràfic","Població assignada total (n)",8224,8035,16259,3771014,3882239,7653253
"Sant Andreu de la Barca","Demogràfic","Població assignada de 0-14 anys (n)",2288,2284,4572,563490,531360,1094850
"Sant Andreu de la Barca","Demogràfic","Població assignada de 15-54 anys (n)",8178,7854,16032,2090135,2009939,4100074
"Sant Andreu de la Barca","Demogràfic","Població assignada de 55-64 anys (n)",1590,1638,3228,485653,501618,987271
"Sant Andreu de la Barca","Demogràfic","Població assignada de 65 anys o més (n)",1965,2624,4589,631736,839322,1471058
"Sant Andreu de la Barca","Demogràfic","Població assignada total (n)",14021,14400,28421,3771014,3882239,7653253
"Sant Andreu de Llavaneres","Demogràfic","Població assignada de 0-14 anys (n)",1423,1368,2791,563490,531360,1094850
"Sant Andreu de Llavaneres","Demogràfic","Població assignada de 15-54 anys (n)",5048,5060,10108,2090135,2009939,4100074
"Sant Andreu de Llavaneres","Demogràfic","Població assignada de 55-64 anys (n)",1406,1355,2761,485653,501618,987271
"Sant Andreu de Llavaneres","Demogràfic","Població assignada de 65 anys o més (n)",1601,1949,3550,631736,839322,1471058
"Sant Andreu de Llavaneres","Demogràfic","Població assignada total (n)",9478,9732,19210,3771014,3882239,7653253
"Sant Boi de Llobregat 01 - Montclar","Demogràfic","Població assignada de 0-14 anys (n)",2870,2732,5602,563490,531360,1094850
"Sant Boi de Llobregat 01 - Montclar","Demogràfic","Població assignada de 15-54 anys (n)",10549,10438,20987,2090135,2009939,4100074
"Sant Boi de Llobregat 01 - Montclar","Demogràfic","Població assignada de 55-64 anys (n)",2587,2875,5462,485653,501618,987271
"Sant Boi de Llobregat 01 - Montclar","Demogràfic","Població assignada de 65 anys o més (n)",3232,4296,7528,631736,839322,1471058
"Sant Boi de Llobregat 01 - Montclar","Demogràfic","Població assignada total (n)",19238,20341,39579,3771014,3882239,7653253
"Sant Boi de Llobregat 02 - Molí Nou","Demogràfic","Població assignada de 0-14 anys (n)",1674,1549,3223,563490,531360,1094850
"Sant Boi de Llobregat 02 - Molí Nou","Demogràfic","Població assignada de 15-54 anys (n)",5911,5835,11746,2090135,2009939,4100074
"Sant Boi de Llobregat 02 - Molí Nou","Demogràfic","Població assignada de 55-64 anys (n)",1295,1236,2531,485653,501618,987271
"Sant Boi de Llobregat 02 - Molí Nou","Demogràfic","Població assignada de 65 anys o més (n)",1785,2450,4235,631736,839322,1471058
"Sant Boi de Llobregat 02 - Molí Nou","Demogràfic","Població assignada total (n)",10665,11070,21735,3771014,3882239,7653253
"Sant Boi De Llobregat 03 - Camps Blancs","Demogràfic","Població assignada de 0-14 anys (n)",925,898,1823,563490,531360,1094850
"Sant Boi De Llobregat 03 - Camps Blancs","Demogràfic","Població assignada de 15-54 anys (n)",3039,2803,5842,2090135,2009939,4100074
"Sant Boi De Llobregat 03 - Camps Blancs","Demogràfic","Població assignada de 55-64 anys (n)",665,643,1308,485653,501618,987271
"Sant Boi De Llobregat 03 - Camps Blancs","Demogràfic","Població assignada de 65 anys o més (n)",813,1194,2007,631736,839322,1471058
"Sant Boi De Llobregat 03 - Camps Blancs","Demogràfic","Població assignada total (n)",5442,5538,10980,3771014,3882239,7653253
"Sant Boi De Llobregat 04 - Vinyets","Demogràfic","Població assignada de 0-14 anys (n)",1439,1345,2784,563490,531360,1094850
"Sant Boi De Llobregat 04 - Vinyets","Demogràfic","Població assignada de 15-54 anys (n)",5486,5279,10765,2090135,2009939,4100074
"Sant Boi De Llobregat 04 - Vinyets","Demogràfic","Població assignada de 55-64 anys (n)",1206,1398,2604,485653,501618,987271
"Sant Boi De Llobregat 04 - Vinyets","Demogràfic","Població assignada de 65 anys o més (n)",1781,2278,4059,631736,839322,1471058
"Sant Boi De Llobregat 04 - Vinyets","Demogràfic","Població assignada total (n)",9912,10300,20212,3771014,3882239,7653253
"Sant Celoni","Demogràfic","Població assignada de 0-14 anys (n)",2949,2709,5658,563490,531360,1094850
"Sant Celoni","Demogràfic","Població assignada de 15-54 anys (n)",9827,9465,19292,2090135,2009939,4100074
"Sant Celoni","Demogràfic","Població assignada de 55-64 anys (n)",2452,2316,4768,485653,501618,987271
"Sant Celoni","Demogràfic","Població assignada de 65 anys o més (n)",2788,3407,6195,631736,839322,1471058
"Sant Celoni","Demogràfic","Població assignada total (n)",18016,17897,35913,3771014,3882239,7653253
"Sant Cugat del Vallès 01","Demogràfic","Població assignada de 0-14 anys (n)",2939,2781,5720,563490,531360,1094850
"Sant Cugat del Vallès 01","Demogràfic","Població assignada de 15-54 anys (n)",9129,9777,18906,2090135,2009939,4100074
"Sant Cugat del Vallès 01","Demogràfic","Població assignada de 55-64 anys (n)",1883,2168,4051,485653,501618,987271
"Sant Cugat del Vallès 01","Demogràfic","Població assignada de 65 anys o més (n)",2384,3324,5708,631736,839322,1471058
"Sant Cugat del Vallès 01","Demogràfic","Població assignada total (n)",16335,18050,34385,3771014,3882239,7653253
"Sant Cugat del Vallès 02","Demogràfic","Població assignada de 0-14 anys (n)",2616,2431,5047,563490,531360,1094850
"Sant Cugat del Vallès 02","Demogràfic","Població assignada de 15-54 anys (n)",8537,8646,17183,2090135,2009939,4100074
"Sant Cugat del Vallès 02","Demogràfic","Població assignada de 55-64 anys (n)",2290,2379,4669,485653,501618,987271
"Sant Cugat del Vallès 02","Demogràfic","Població assignada de 65 anys o més (n)",2625,2993,5618,631736,839322,1471058
"Sant Cugat del Vallès 02","Demogràfic","Població assignada total (n)",16068,16449,32517,3771014,3882239,7653253
"Sant Cugat del Vallès 03","Demogràfic","Població assignada de 0-14 anys (n)",3167,2942,6109,563490,531360,1094850
"Sant Cugat del Vallès 03","Demogràfic","Població assignada de 15-54 anys (n)",7216,7777,14993,2090135,2009939,4100074
"Sant Cugat del Vallès 03","Demogràfic","Població assignada de 55-64 anys (n)",1531,1425,2956,485653,501618,987271
"Sant Cugat del Vallès 03","Demogràfic","Població assignada de 65 anys o més (n)",1042,1245,2287,631736,839322,1471058
"Sant Cugat del Vallès 03","Demogràfic","Població assignada total (n)",12956,13389,26345,3771014,3882239,7653253
"Sant Feliu de Guíxols","Demogràfic","Població assignada de 0-14 anys (n)",2671,2579,5250,563490,531360,1094850
"Sant Feliu de Guíxols","Demogràfic","Població assignada de 15-54 anys (n)",9792,9543,19335,2090135,2009939,4100074
"Sant Feliu de Guíxols","Demogràfic","Població assignada de 55-64 anys (n)",2484,2467,4951,485653,501618,987271
"Sant Feliu de Guíxols","Demogràfic","Població assignada de 65 anys o més (n)",3158,4041,7199,631736,839322,1471058
"Sant Feliu de Guíxols","Demogràfic","Població assignada total (n)",18105,18630,36735,3771014,3882239,7653253
"Sant Feliu de Llobregat 01 - El Pla","Demogràfic","Població assignada de 0-14 anys (n)",1251,1234,2485,563490,531360,1094850
"Sant Feliu de Llobregat 01 - El Pla","Demogràfic","Població assignada de 15-54 anys (n)",4794,4641,9435,2090135,2009939,4100074
"Sant Feliu de Llobregat 01 - El Pla","Demogràfic","Població assignada de 55-64 anys (n)",1033,1160,2193,485653,501618,987271
"Sant Feliu de Llobregat 01 - El Pla","Demogràfic","Població assignada de 65 anys o més (n)",1543,2066,3609,631736,839322,1471058
"Sant Feliu de Llobregat 01 - El Pla","Demogràfic","Població assignada total (n)",8621,9101,17722,3771014,3882239,7653253
"Sant Feliu deLlobregat 02 - Rambla","Demogràfic","Població assignada de 0-14 anys (n)",2070,1913,3983,563490,531360,1094850
"Sant Feliu deLlobregat 02 - Rambla","Demogràfic","Població assignada de 15-54 anys (n)",7229,7231,14460,2090135,2009939,4100074
"Sant Feliu deLlobregat 02 - Rambla","Demogràfic","Població assignada de 55-64 anys (n)",1644,1720,3364,485653,501618,987271
"Sant Feliu deLlobregat 02 - Rambla","Demogràfic","Població assignada de 65 anys o més (n)",2262,2983,5245,631736,839322,1471058
"Sant Feliu deLlobregat 02 - Rambla","Demogràfic","Població assignada total (n)",13205,13847,27052,3771014,3882239,7653253
"Sant Hipòlit de Voltregà","Demogràfic","Població assignada de 0-14 anys (n)",423,355,778,563490,531360,1094850
"Sant Hipòlit de Voltregà","Demogràfic","Població assignada de 15-54 anys (n)",1794,1665,3459,2090135,2009939,4100074
"Sant Hipòlit de Voltregà","Demogràfic","Població assignada de 55-64 anys (n)",488,483,971,485653,501618,987271
"Sant Hipòlit de Voltregà","Demogràfic","Població assignada de 65 anys o més (n)",583,744,1327,631736,839322,1471058
"Sant Hipòlit de Voltregà","Demogràfic","Població assignada total (n)",3288,3247,6535,3771014,3882239,7653253
"Sant Joan de Vilatorrada","Demogràfic","Població assignada de 0-14 anys (n)",925,880,1805,563490,531360,1094850
"Sant Joan de Vilatorrada","Demogràfic","Població assignada de 15-54 anys (n)",3430,3195,6625,2090135,2009939,4100074
"Sant Joan de Vilatorrada","Demogràfic","Població assignada de 55-64 anys (n)",844,832,1676,485653,501618,987271
"Sant Joan de Vilatorrada","Demogràfic","Població assignada de 65 anys o més (n)",1158,1342,2500,631736,839322,1471058
"Sant Joan de Vilatorrada","Demogràfic","Població assignada total (n)",6357,6249,12606,3771014,3882239,7653253
"Sant Joan Despí 01","Demogràfic","Població assignada de 0-14 anys (n)",1586,1482,3068,563490,531360,1094850
"Sant Joan Despí 01","Demogràfic","Població assignada de 15-54 anys (n)",5527,5539,11066,2090135,2009939,4100074
"Sant Joan Despí 01","Demogràfic","Població assignada de 55-64 anys (n)",1275,1355,2630,485653,501618,987271
"Sant Joan Despí 01","Demogràfic","Població assignada de 65 anys o més (n)",1562,1992,3554,631736,839322,1471058
"Sant Joan Despí 01","Demogràfic","Població assignada total (n)",9950,10368,20318,3771014,3882239,7653253
"Sant Joan Despí 02 - Les Planes","Demogràfic","Població assignada de 0-14 anys (n)",1016,984,2000,563490,531360,1094850
"Sant Joan Despí 02 - Les Planes","Demogràfic","Població assignada de 15-54 anys (n)",3643,3614,7257,2090135,2009939,4100074
"Sant Joan Despí 02 - Les Planes","Demogràfic","Població assignada de 55-64 anys (n)",881,946,1827,485653,501618,987271
"Sant Joan Despí 02 - Les Planes","Demogràfic","Població assignada de 65 anys o més (n)",1129,1470,2599,631736,839322,1471058
"Sant Joan Despí 02 - Les Planes","Demogràfic","Població assignada total (n)",6669,7014,13683,3771014,3882239,7653253
"Sant Joan les Fonts","Demogràfic","Població assignada de 0-14 anys (n)",450,422,872,563490,531360,1094850
"Sant Joan les Fonts","Demogràfic","Població assignada de 15-54 anys (n)",1476,1357,2833,2090135,2009939,4100074
"Sant Joan les Fonts","Demogràfic","Població assignada de 55-64 anys (n)",382,357,739,485653,501618,987271
"Sant Joan les Fonts","Demogràfic","Població assignada de 65 anys o més (n)",595,678,1273,631736,839322,1471058
"Sant Joan les Fonts","Demogràfic","Població assignada total (n)",2903,2814,5717,3771014,3882239,7653253
"Sant Just Desvern","Demogràfic","Població assignada de 0-14 anys (n)",1686,1617,3303,563490,531360,1094850
"Sant Just Desvern","Demogràfic","Població assignada de 15-54 anys (n)",4987,5168,10155,2090135,2009939,4100074
"Sant Just Desvern","Demogràfic","Població assignada de 55-64 anys (n)",1081,1174,2255,485653,501618,987271
"Sant Just Desvern","Demogràfic","Població assignada de 65 anys o més (n)",1622,2122,3744,631736,839322,1471058
"Sant Just Desvern","Demogràfic","Població assignada total (n)",9376,10081,19457,3771014,3882239,7653253
"Sant Quirze de Besora","Demogràfic","Població assignada de 0-14 anys (n)",318,328,646,563490,531360,1094850
"Sant Quirze de Besora","Demogràfic","Població assignada de 15-54 anys (n)",1195,1056,2251,2090135,2009939,4100074
"Sant Quirze de Besora","Demogràfic","Població assignada de 55-64 anys (n)",336,295,631,485653,501618,987271
"Sant Quirze de Besora","Demogràfic","Població assignada de 65 anys o més (n)",515,700,1215,631736,839322,1471058
"Sant Quirze de Besora","Demogràfic","Població assignada total (n)",2364,2379,4743,3771014,3882239,7653253
"Sant Quirze del Vallès","Demogràfic","Població assignada de 0-14 anys (n)",1534,1451,2985,563490,531360,1094850
"Sant Quirze del Vallès","Demogràfic","Població assignada de 15-54 anys (n)",4951,5066,10017,2090135,2009939,4100074
"Sant Quirze del Vallès","Demogràfic","Població assignada de 55-64 anys (n)",1237,1328,2565,485653,501618,987271
"Sant Quirze del Vallès","Demogràfic","Població assignada de 65 anys o més (n)",1393,1576,2969,631736,839322,1471058
"Sant Quirze del Vallès","Demogràfic","Població assignada total (n)",9115,9421,18536,3771014,3882239,7653253
"Sant Sadurní d'Anoia","Demogràfic","Població assignada de 0-14 anys (n)",1778,1638,3416,563490,531360,1094850
"Sant Sadurní d'Anoia","Demogràfic","Població assignada de 15-54 anys (n)",6072,5704,11776,2090135,2009939,4100074
"Sant Sadurní d'Anoia","Demogràfic","Població assignada de 55-64 anys (n)",1526,1517,3043,485653,501618,987271
"Sant Sadurní d'Anoia","Demogràfic","Població assignada de 65 anys o més (n)",1913,2309,4222,631736,839322,1471058
"Sant Sadurní d'Anoia","Demogràfic","Població assignada total (n)",11289,11168,22457,3771014,3882239,7653253
"Sant Vicenç de Castellet","Demogràfic","Població assignada de 0-14 anys (n)",1323,1146,2469,563490,531360,1094850
"Sant Vicenç de Castellet","Demogràfic","Població assignada de 15-54 anys (n)",4156,3874,8030,2090135,2009939,4100074
"Sant Vicenç de Castellet","Demogràfic","Població assignada de 55-64 anys (n)",992,936,1928,485653,501618,987271
"Sant Vicenç de Castellet","Demogràfic","Població assignada de 65 anys o més (n)",1324,1677,3001,631736,839322,1471058
"Sant Vicenç de Castellet","Demogràfic","Població assignada total (n)",7795,7633,15428,3771014,3882239,7653253
"Sant Vicenç dels Horts 01 - Vila Vella","Demogràfic","Població assignada de 0-14 anys (n)",2110,2066,4176,563490,531360,1094850
"Sant Vicenç dels Horts 01 - Vila Vella","Demogràfic","Població assignada de 15-54 anys (n)",7166,6909,14075,2090135,2009939,4100074
"Sant Vicenç dels Horts 01 - Vila Vella","Demogràfic","Població assignada de 55-64 anys (n)",1802,1800,3602,485653,501618,987271
"Sant Vicenç dels Horts 01 - Vila Vella","Demogràfic","Població assignada de 65 anys o més (n)",1983,2489,4472,631736,839322,1471058
"Sant Vicenç dels Horts 01 - Vila Vella","Demogràfic","Població assignada total (n)",13061,13264,26325,3771014,3882239,7653253
"Sant Vicenç dels Horts 02 - El Serral","Demogràfic","Població assignada de 0-14 anys (n)",417,414,831,563490,531360,1094850
"Sant Vicenç dels Horts 02 - El Serral","Demogràfic","Població assignada de 15-54 anys (n)",2049,1956,4005,2090135,2009939,4100074
"Sant Vicenç dels Horts 02 - El Serral","Demogràfic","Població assignada de 55-64 anys (n)",491,531,1022,485653,501618,987271
"Sant Vicenç dels Horts 02 - El Serral","Demogràfic","Població assignada de 65 anys o més (n)",533,707,1240,631736,839322,1471058
"Sant Vicenç dels Horts 02 - El Serral","Demogràfic","Població assignada total (n)",3490,3608,7098,3771014,3882239,7653253
"Santa Coloma de Farners","Demogràfic","Població assignada de 0-14 anys (n)",1374,1342,2716,563490,531360,1094850
"Santa Coloma de Farners","Demogràfic","Població assignada de 15-54 anys (n)",4784,4217,9001,2090135,2009939,4100074
"Santa Coloma de Farners","Demogràfic","Població assignada de 55-64 anys (n)",1046,954,2000,485653,501618,987271
"Santa Coloma de Farners","Demogràfic","Població assignada de 65 anys o més (n)",1322,1600,2922,631736,839322,1471058
"Santa Coloma de Farners","Demogràfic","Població assignada total (n)",8526,8113,16639,3771014,3882239,7653253
"Santa Coloma de Gramenet 01 - Can Mariner","Demogràfic","Població assignada de 0-14 anys (n)",1606,1536,3142,563490,531360,1094850
"Santa Coloma de Gramenet 01 - Can Mariner","Demogràfic","Població assignada de 15-54 anys (n)",6075,5852,11927,2090135,2009939,4100074
"Santa Coloma de Gramenet 01 - Can Mariner","Demogràfic","Població assignada de 55-64 anys (n)",1359,1510,2869,485653,501618,987271
"Santa Coloma de Gramenet 01 - Can Mariner","Demogràfic","Població assignada de 65 anys o més (n)",1943,2770,4713,631736,839322,1471058
"Santa Coloma de Gramenet 01 - Can Mariner","Demogràfic","Població assignada total (n)",10983,11668,22651,3771014,3882239,7653253
"Santa Coloma de Gramenet 02 - Llatí","Demogràfic","Població assignada de 0-14 anys (n)",1042,1021,2063,563490,531360,1094850
"Santa Coloma de Gramenet 02 - Llatí","Demogràfic","Població assignada de 15-54 anys (n)",3892,3681,7573,2090135,2009939,4100074
"Santa Coloma de Gramenet 02 - Llatí","Demogràfic","Població assignada de 55-64 anys (n)",814,854,1668,485653,501618,987271
"Santa Coloma de Gramenet 02 - Llatí","Demogràfic","Població assignada de 65 anys o més (n)",1260,1659,2919,631736,839322,1471058
"Santa Coloma de Gramenet 02 - Llatí","Demogràfic","Població assignada total (n)",7008,7215,14223,3771014,3882239,7653253
"Santa Coloma de Gramenet 03 - Singuerlín","Demogràfic","Població assignada de 0-14 anys (n)",1298,1322,2620,563490,531360,1094850
"Santa Coloma de Gramenet 03 - Singuerlín","Demogràfic","Població assignada de 15-54 anys (n)",5115,4744,9859,2090135,2009939,4100074
"Santa Coloma de Gramenet 03 - Singuerlín","Demogràfic","Població assignada de 55-64 anys (n)",1129,1114,2243,485653,501618,987271
"Santa Coloma de Gramenet 03 - Singuerlín","Demogràfic","Població assignada de 65 anys o més (n)",1741,2323,4064,631736,839322,1471058
"Santa Coloma de Gramenet 03 - Singuerlín","Demogràfic","Població assignada total (n)",9283,9503,18786,3771014,3882239,7653253
"Santa Coloma de Gramenet 04 - Riu Nord - Riu Sud","Demogràfic","Població assignada de 0-14 anys (n)",1558,1494,3052,563490,531360,1094850
"Santa Coloma de Gramenet 04 - Riu Nord - Riu Sud","Demogràfic","Població assignada de 15-54 anys (n)",5799,5935,11734,2090135,2009939,4100074
"Santa Coloma de Gramenet 04 - Riu Nord - Riu Sud","Demogràfic","Població assignada de 55-64 anys (n)",1299,1497,2796,485653,501618,987271
"Santa Coloma de Gramenet 04 - Riu Nord - Riu Sud","Demogràfic","Població assignada de 65 anys o més (n)",2328,3181,5509,631736,839322,1471058
"Santa Coloma de Gramenet 04 - Riu Nord - Riu Sud","Demogràfic","Població assignada total (n)",10984,12107,23091,3771014,3882239,7653253
"Santa Coloma de Gramenet 05 - Santa Rosa","Demogràfic","Població assignada de 0-14 anys (n)",1497,1395,2892,563490,531360,1094850
"Santa Coloma de Gramenet 05 - Santa Rosa","Demogràfic","Població assignada de 15-54 anys (n)",5688,4825,10513,2090135,2009939,4100074
"Santa Coloma de Gramenet 05 - Santa Rosa","Demogràfic","Població assignada de 55-64 anys (n)",1010,1029,2039,485653,501618,987271
"Santa Coloma de Gramenet 05 - Santa Rosa","Demogràfic","Població assignada de 65 anys o més (n)",1146,1636,2782,631736,839322,1471058
"Santa Coloma de Gramenet 05 - Santa Rosa","Demogràfic","Població assignada total (n)",9341,8885,18226,3771014,3882239,7653253
"Santa Coloma de Gramenet 06 - Fondo","Demogràfic","Població assignada de 0-14 anys (n)",1956,1796,3752,563490,531360,1094850
"Santa Coloma de Gramenet 06 - Fondo","Demogràfic","Població assignada de 15-54 anys (n)",6923,6337,13260,2090135,2009939,4100074
"Santa Coloma de Gramenet 06 - Fondo","Demogràfic","Població assignada de 55-64 anys (n)",1316,1185,2501,485653,501618,987271
"Santa Coloma de Gramenet 06 - Fondo","Demogràfic","Població assignada de 65 anys o més (n)",1395,1959,3354,631736,839322,1471058
"Santa Coloma de Gramenet 06 - Fondo","Demogràfic","Població assignada total (n)",11590,11277,22867,3771014,3882239,7653253
"Santa Coloma de Queralt","Demogràfic","Població assignada de 0-14 anys (n)",241,204,445,563490,531360,1094850
"Santa Coloma de Queralt","Demogràfic","Població assignada de 15-54 anys (n)",840,758,1598,2090135,2009939,4100074
"Santa Coloma de Queralt","Demogràfic","Població assignada de 55-64 anys (n)",231,198,429,485653,501618,987271
"Santa Coloma de Queralt","Demogràfic","Població assignada de 65 anys o més (n)",368,461,829,631736,839322,1471058
"Santa Coloma de Queralt","Demogràfic","Població assignada total (n)",1680,1621,3301,3771014,3882239,7653253
"Santa Eugènia de Berga","Demogràfic","Població assignada de 0-14 anys (n)",1261,1143,2404,563490,531360,1094850
"Santa Eugènia de Berga","Demogràfic","Població assignada de 15-54 anys (n)",4540,4162,8702,2090135,2009939,4100074
"Santa Eugènia de Berga","Demogràfic","Població assignada de 55-64 anys (n)",1270,1236,2506,485653,501618,987271
"Santa Eugènia de Berga","Demogràfic","Població assignada de 65 anys o més (n)",1557,1809,3366,631736,839322,1471058
"Santa Eugènia de Berga","Demogràfic","Població assignada total (n)",8628,8350,16978,3771014,3882239,7653253
"Santa Margarida de Montbui","Demogràfic","Població assignada de 0-14 anys (n)",1018,927,1945,563490,531360,1094850
"Santa Margarida de Montbui","Demogràfic","Població assignada de 15-54 anys (n)",2922,2600,5522,2090135,2009939,4100074
"Santa Margarida de Montbui","Demogràfic","Població assignada de 55-64 anys (n)",645,679,1324,485653,501618,987271
"Santa Margarida de Montbui","Demogràfic","Població assignada de 65 anys o més (n)",805,1031,1836,631736,839322,1471058
"Santa Margarida de Montbui","Demogràfic","Població assignada total (n)",5390,5237,10627,3771014,3882239,7653253
"Santa Perpètua de Mogoda","Demogràfic","Població assignada de 0-14 anys (n)",2024,1847,3871,563490,531360,1094850
"Santa Perpètua de Mogoda","Demogràfic","Població assignada de 15-54 anys (n)",7110,6613,13723,2090135,2009939,4100074
"Santa Perpètua de Mogoda","Demogràfic","Població assignada de 55-64 anys (n)",1552,1571,3123,485653,501618,987271
"Santa Perpètua de Mogoda","Demogràfic","Població assignada de 65 anys o més (n)",1866,2272,4138,631736,839322,1471058
"Santa Perpètua de Mogoda","Demogràfic","Població assignada total (n)",12552,12303,24855,3771014,3882239,7653253
"Sarrià de Ter","Demogràfic","Població assignada de 0-14 anys (n)",1322,1158,2480,563490,531360,1094850
"Sarrià de Ter","Demogràfic","Població assignada de 15-54 anys (n)",3870,3870,7740,2090135,2009939,4100074
"Sarrià de Ter","Demogràfic","Població assignada de 55-64 anys (n)",927,853,1780,485653,501618,987271
"Sarrià de Ter","Demogràfic","Població assignada de 65 anys o més (n)",1049,1276,2325,631736,839322,1471058
"Sarrià de Ter","Demogràfic","Població assignada total (n)",7168,7157,14325,3771014,3882239,7653253
"Seròs","Demogràfic","Població assignada de 0-14 anys (n)",482,464,946,563490,531360,1094850
"Seròs","Demogràfic","Població assignada de 15-54 anys (n)",1999,1418,3417,2090135,2009939,4100074
"Seròs","Demogràfic","Població assignada de 55-64 anys (n)",533,427,960,485653,501618,987271
"Seròs","Demogràfic","Població assignada de 65 anys o més (n)",747,855,1602,631736,839322,1471058
"Seròs","Demogràfic","Població assignada total (n)",3761,3164,6925,3771014,3882239,7653253
"Sils - Vidreres - Maçanet de la Selva","Demogràfic","Població assignada de 0-14 anys (n)",1754,1683,3437,563490,531360,1094850
"Sils - Vidreres - Maçanet de la Selva","Demogràfic","Població assignada de 15-54 anys (n)",6447,5941,12388,2090135,2009939,4100074
"Sils - Vidreres - Maçanet de la Selva","Demogràfic","Població assignada de 55-64 anys (n)",1503,1436,2939,485653,501618,987271
"Sils - Vidreres - Maçanet de la Selva","Demogràfic","Població assignada de 65 anys o més (n)",1988,2158,4146,631736,839322,1471058
"Sils - Vidreres - Maçanet de la Selva","Demogràfic","Població assignada total (n)",11692,11218,22910,3771014,3882239,7653253
"Sitges","Demogràfic","Població assignada de 0-14 anys (n)",1804,1719,3523,563490,531360,1094850
"Sitges","Demogràfic","Població assignada de 15-54 anys (n)",7148,7145,14293,2090135,2009939,4100074
"Sitges","Demogràfic","Població assignada de 55-64 anys (n)",2078,1861,3939,485653,501618,987271
"Sitges","Demogràfic","Població assignada de 65 anys o més (n)",2332,2969,5301,631736,839322,1471058
"Sitges","Demogràfic","Població assignada total (n)",13362,13694,27056,3771014,3882239,7653253
"Solsonès","Demogràfic","Població assignada de 0-14 anys (n)",1007,908,1915,563490,531360,1094850
"Solsonès","Demogràfic","Població assignada de 15-54 anys (n)",3281,3131,6412,2090135,2009939,4100074
"Solsonès","Demogràfic","Població assignada de 55-64 anys (n)",950,852,1802,485653,501618,987271
"Solsonès","Demogràfic","Població assignada de 65 anys o més (n)",1237,1462,2699,631736,839322,1471058
"Solsonès","Demogràfic","Població assignada total (n)",6475,6353,12828,3771014,3882239,7653253
"Súria","Demogràfic","Població assignada de 0-14 anys (n)",628,592,1220,563490,531360,1094850
"Súria","Demogràfic","Població assignada de 15-54 anys (n)",2158,2025,4183,2090135,2009939,4100074
"Súria","Demogràfic","Població assignada de 55-64 anys (n)",655,648,1303,485653,501618,987271
"Súria","Demogràfic","Població assignada de 65 anys o més (n)",867,1205,2072,631736,839322,1471058
"Súria","Demogràfic","Població assignada total (n)",4308,4470,8778,3771014,3882239,7653253
"Tarragona 01 - Bonavista - La Canonja","Demogràfic","Població assignada de 0-14 anys (n)",1269,1235,2504,563490,531360,1094850
"Tarragona 01 - Bonavista - La Canonja","Demogràfic","Població assignada de 15-54 anys (n)",4197,3903,8100,2090135,2009939,4100074
"Tarragona 01 - Bonavista - La Canonja","Demogràfic","Població assignada de 55-64 anys (n)",945,908,1853,485653,501618,987271
"Tarragona 01 - Bonavista - La Canonja","Demogràfic","Població assignada de 65 anys o més (n)",1047,1290,2337,631736,839322,1471058
"Tarragona 01 - Bonavista - La Canonja","Demogràfic","Població assignada total (n)",7458,7336,14794,3771014,3882239,7653253
"Tarragona 02 - La Granja - Torreforta","Demogràfic","Població assignada de 0-14 anys (n)",2375,2151,4526,563490,531360,1094850
"Tarragona 02 - La Granja - Torreforta","Demogràfic","Població assignada de 15-54 anys (n)",7882,7221,15103,2090135,2009939,4100074
"Tarragona 02 - La Granja - Torreforta","Demogràfic","Població assignada de 55-64 anys (n)",1688,1713,3401,485653,501618,987271
"Tarragona 02 - La Granja - Torreforta","Demogràfic","Població assignada de 65 anys o més (n)",1858,2381,4239,631736,839322,1471058
"Tarragona 02 - La Granja - Torreforta","Demogràfic","Població assignada total (n)",13803,13466,27269,3771014,3882239,7653253
"Tarragona 03 - Jaume I","Demogràfic","Població assignada de 0-14 anys (n)",2478,2480,4958,563490,531360,1094850
"Tarragona 03 - Jaume I","Demogràfic","Població assignada de 15-54 anys (n)",7945,8036,15981,2090135,2009939,4100074
"Tarragona 03 - Jaume I","Demogràfic","Població assignada de 55-64 anys (n)",1848,2192,4040,485653,501618,987271
"Tarragona 03 - Jaume I","Demogràfic","Població assignada de 65 anys o més (n)",2621,3683,6304,631736,839322,1471058
"Tarragona 03 - Jaume I","Demogràfic","Població assignada total (n)",14892,16391,31283,3771014,3882239,7653253
"Tarragona 04","Demogràfic","Població assignada de 0-14 anys (n)",1565,1452,3017,563490,531360,1094850
"Tarragona 04","Demogràfic","Població assignada de 15-54 anys (n)",4284,4432,8716,2090135,2009939,4100074
"Tarragona 04","Demogràfic","Població assignada de 55-64 anys (n)",1132,1142,2274,485653,501618,987271
"Tarragona 04","Demogràfic","Població assignada de 65 anys o més (n)",1416,1639,3055,631736,839322,1471058
"Tarragona 04","Demogràfic","Població assignada total (n)",8397,8665,17062,3771014,3882239,7653253
"Tarragona 05 - Sant Pere i Sant Pau","Demogràfic","Població assignada de 0-14 anys (n)",1371,1240,2611,563490,531360,1094850
"Tarragona 05 - Sant Pere i Sant Pau","Demogràfic","Població assignada de 15-54 anys (n)",4810,4643,9453,2090135,2009939,4100074
"Tarragona 05 - Sant Pere i Sant Pau","Demogràfic","Població assignada de 55-64 anys (n)",981,1075,2056,485653,501618,987271
"Tarragona 05 - Sant Pere i Sant Pau","Demogràfic","Població assignada de 65 anys o més (n)",1203,1465,2668,631736,839322,1471058
"Tarragona 05 - Sant Pere i Sant Pau","Demogràfic","Població assignada total (n)",8365,8423,16788,3771014,3882239,7653253
"Tarragona 06 - Tarragonès","Demogràfic","Població assignada de 0-14 anys (n)",815,785,1600,563490,531360,1094850
"Tarragona 06 - Tarragonès","Demogràfic","Població assignada de 15-54 anys (n)",4453,4302,8755,2090135,2009939,4100074
"Tarragona 06 - Tarragonès","Demogràfic","Població assignada de 55-64 anys (n)",1068,1199,2267,485653,501618,987271
"Tarragona 06 - Tarragonès","Demogràfic","Població assignada de 65 anys o més (n)",1399,2044,3443,631736,839322,1471058
"Tarragona 06 - Tarragonès","Demogràfic","Població assignada total (n)",7735,8330,16065,3771014,3882239,7653253
"Tarragona 07 - Sant Salvador","Demogràfic","Població assignada de 0-14 anys (n)",1089,890,1979,563490,531360,1094850
"Tarragona 07 - Sant Salvador","Demogràfic","Població assignada de 15-54 anys (n)",3185,2948,6133,2090135,2009939,4100074
"Tarragona 07 - Sant Salvador","Demogràfic","Població assignada de 55-64 anys (n)",697,625,1322,485653,501618,987271
"Tarragona 07 - Sant Salvador","Demogràfic","Població assignada de 65 anys o més (n)",689,844,1533,631736,839322,1471058
"Tarragona 07 - Sant Salvador","Demogràfic","Població assignada total (n)",5660,5307,10967,3771014,3882239,7653253
"Tarragona 08 - Muralles","Demogràfic","Població assignada de 0-14 anys (n)",1054,1016,2070,563490,531360,1094850
"Tarragona 08 - Muralles","Demogràfic","Població assignada de 15-54 anys (n)",5190,5457,10647,2090135,2009939,4100074
"Tarragona 08 - Muralles","Demogràfic","Població assignada de 55-64 anys (n)",1123,1281,2404,485653,501618,987271
"Tarragona 08 - Muralles","Demogràfic","Població assignada de 65 anys o més (n)",1641,2366,4007,631736,839322,1471058
"Tarragona 08 - Muralles","Demogràfic","Població assignada total (n)",9008,10120,19128,3771014,3882239,7653253
"Tàrrega","Demogràfic","Població assignada de 0-14 anys (n)",1937,1838,3775,563490,531360,1094850
"Tàrrega","Demogràfic","Població assignada de 15-54 anys (n)",6492,5943,12435,2090135,2009939,4100074
"Tàrrega","Demogràfic","Població assignada de 55-64 anys (n)",1644,1529,3173,485653,501618,987271
"Tàrrega","Demogràfic","Població assignada de 65 anys o més (n)",2046,2592,4638,631736,839322,1471058
"Tàrrega","Demogràfic","Població assignada total (n)",12119,11902,24021,3771014,3882239,7653253
"Terra Alta","Demogràfic","Població assignada de 0-14 anys (n)",642,607,1249,563490,531360,1094850
"Terra Alta","Demogràfic","Població assignada de 15-54 anys (n)",2542,2198,4740,2090135,2009939,4100074
"Terra Alta","Demogràfic","Població assignada de 55-64 anys (n)",811,742,1553,485653,501618,987271
"Terra Alta","Demogràfic","Població assignada de 65 anys o més (n)",1457,1737,3194,631736,839322,1471058
"Terra Alta","Demogràfic","Població assignada total (n)",5452,5284,10736,3771014,3882239,7653253
"Terrassa A - Sant Llàtzer","Demogràfic","Població assignada de 0-14 anys (n)",3433,3297,6730,563490,531360,1094850
"Terrassa A - Sant Llàtzer","Demogràfic","Població assignada de 15-54 anys (n)",11463,11686,23149,2090135,2009939,4100074
"Terrassa A - Sant Llàtzer","Demogràfic","Població assignada de 55-64 anys (n)",2624,2774,5398,485653,501618,987271
"Terrassa A - Sant Llàtzer","Demogràfic","Població assignada de 65 anys o més (n)",3108,4612,7720,631736,839322,1471058
"Terrassa A - Sant Llàtzer","Demogràfic","Població assignada total (n)",20628,22369,42997,3771014,3882239,7653253
"Terrassa B - Est","Demogràfic","Població assignada de 0-14 anys (n)",3034,2862,5896,563490,531360,1094850
"Terrassa B - Est","Demogràfic","Població assignada de 15-54 anys (n)",8536,7680,16216,2090135,2009939,4100074
"Terrassa B - Est","Demogràfic","Població assignada de 55-64 anys (n)",1479,1308,2787,485653,501618,987271
"Terrassa B - Est","Demogràfic","Població assignada de 65 anys o més (n)",1256,1600,2856,631736,839322,1471058
"Terrassa B - Est","Demogràfic","Població assignada total (n)",14305,13450,27755,3771014,3882239,7653253
"Terrassa C - Antoni Creus","Demogràfic","Població assignada de 0-14 anys (n)",951,854,1805,563490,531360,1094850
"Terrassa C - Antoni Creus","Demogràfic","Població assignada de 15-54 anys (n)",2995,2892,5887,2090135,2009939,4100074
"Terrassa C - Antoni Creus","Demogràfic","Població assignada de 55-64 anys (n)",681,693,1374,485653,501618,987271
"Terrassa C - Antoni Creus","Demogràfic","Població assignada de 65 anys o més (n)",894,1133,2027,631736,839322,1471058
"Terrassa C - Antoni Creus","Demogràfic","Població assignada total (n)",5521,5572,11093,3771014,3882239,7653253
"Terrassa D - Oest","Demogràfic","Població assignada de 0-14 anys (n)",2626,2434,5060,563490,531360,1094850
"Terrassa D - Oest","Demogràfic","Població assignada de 15-54 anys (n)",9087,8590,17677,2090135,2009939,4100074
"Terrassa D - Oest","Demogràfic","Població assignada de 55-64 anys (n)",2170,2034,4204,485653,501618,987271
"Terrassa D - Oest","Demogràfic","Població assignada de 65 anys o més (n)",2304,2823,5127,631736,839322,1471058
"Terrassa D - Oest","Demogràfic","Població assignada total (n)",16187,15881,32068,3771014,3882239,7653253
"Terrassa E - Rambla","Demogràfic","Població assignada de 0-14 anys (n)",4586,4237,8823,563490,531360,1094850
"Terrassa E - Rambla","Demogràfic","Població assignada de 15-54 anys (n)",16629,17005,33634,2090135,2009939,4100074
"Terrassa E - Rambla","Demogràfic","Població assignada de 55-64 anys (n)",4122,4528,8650,485653,501618,987271
"Terrassa E - Rambla","Demogràfic","Població assignada de 65 anys o més (n)",5715,7829,13544,631736,839322,1471058
"Terrassa E - Rambla","Demogràfic","Població assignada total (n)",31052,33599,64651,3771014,3882239,7653253
"Terrassa F - Nord","Demogràfic","Població assignada de 0-14 anys (n)",3336,3167,6503,563490,531360,1094850
"Terrassa F - Nord","Demogràfic","Població assignada de 15-54 anys (n)",11947,10980,22927,2090135,2009939,4100074
"Terrassa F - Nord","Demogràfic","Població assignada de 55-64 anys (n)",2861,2887,5748,485653,501618,987271
"Terrassa F - Nord","Demogràfic","Població assignada de 65 anys o més (n)",3186,4049,7235,631736,839322,1471058
"Terrassa F - Nord","Demogràfic","Població assignada total (n)",21330,21083,42413,3771014,3882239,7653253
"Terrassa G - Sud","Demogràfic","Població assignada de 0-14 anys (n)",2000,1807,3807,563490,531360,1094850
"Terrassa G - Sud","Demogràfic","Població assignada de 15-54 anys (n)",6753,6328,13081,2090135,2009939,4100074
"Terrassa G - Sud","Demogràfic","Població assignada de 55-64 anys (n)",1449,1408,2857,485653,501618,987271
"Terrassa G - Sud","Demogràfic","Població assignada de 65 anys o més (n)",1633,2186,3819,631736,839322,1471058
"Terrassa G - Sud","Demogràfic","Població assignada total (n)",11835,11729,23564,3771014,3882239,7653253
"Tona","Demogràfic","Població assignada de 0-14 anys (n)",880,816,1696,563490,531360,1094850
"Tona","Demogràfic","Població assignada de 15-54 anys (n)",3158,2957,6115,2090135,2009939,4100074
"Tona","Demogràfic","Població assignada de 55-64 anys (n)",874,856,1730,485653,501618,987271
"Tona","Demogràfic","Població assignada de 65 anys o més (n)",1052,1299,2351,631736,839322,1471058
"Tona","Demogràfic","Població assignada total (n)",5964,5928,11892,3771014,3882239,7653253
"Tordera","Demogràfic","Població assignada de 0-14 anys (n)",1518,1405,2923,563490,531360,1094850
"Tordera","Demogràfic","Població assignada de 15-54 anys (n)",5035,4683,9718,2090135,2009939,4100074
"Tordera","Demogràfic","Població assignada de 55-64 anys (n)",1117,1127,2244,485653,501618,987271
"Tordera","Demogràfic","Població assignada de 65 anys o més (n)",1524,1800,3324,631736,839322,1471058
"Tordera","Demogràfic","Població assignada total (n)",9194,9015,18209,3771014,3882239,7653253
"Torredembarra","Demogràfic","Població assignada de 0-14 anys (n)",2858,2781,5639,563490,531360,1094850
"Torredembarra","Demogràfic","Població assignada de 15-54 anys (n)",9496,9271,18767,2090135,2009939,4100074
"Torredembarra","Demogràfic","Població assignada de 55-64 anys (n)",2437,2468,4905,485653,501618,987271
"Torredembarra","Demogràfic","Població assignada de 65 anys o més (n)",3498,4199,7697,631736,839322,1471058
"Torredembarra","Demogràfic","Població assignada total (n)",18289,18719,37008,3771014,3882239,7653253
"Torroella de Montgrí","Demogràfic","Població assignada de 0-14 anys (n)",1212,1135,2347,563490,531360,1094850
"Torroella de Montgrí","Demogràfic","Població assignada de 15-54 anys (n)",4286,3740,8026,2090135,2009939,4100074
"Torroella de Montgrí","Demogràfic","Població assignada de 55-64 anys (n)",1136,1021,2157,485653,501618,987271
"Torroella de Montgrí","Demogràfic","Població assignada de 65 anys o més (n)",1415,1560,2975,631736,839322,1471058
"Torroella de Montgrí","Demogràfic","Població assignada total (n)",8049,7456,15505,3771014,3882239,7653253
"Tortosa 01 - Est - El Temple","Demogràfic","Població assignada de 0-14 anys (n)",1483,1415,2898,563490,531360,1094850
"Tortosa 01 - Est - El Temple","Demogràfic","Població assignada de 15-54 anys (n)",5575,5139,10714,2090135,2009939,4100074
"Tortosa 01 - Est - El Temple","Demogràfic","Població assignada de 55-64 anys (n)",1471,1435,2906,485653,501618,987271
"Tortosa 01 - Est - El Temple","Demogràfic","Població assignada de 65 anys o més (n)",1708,2294,4002,631736,839322,1471058
"Tortosa 01 - Est - El Temple","Demogràfic","Població assignada total (n)",10237,10283,20520,3771014,3882239,7653253
"Tortosa 02 - Oest","Demogràfic","Població assignada de 0-14 anys (n)",2031,1927,3958,563490,531360,1094850
"Tortosa 02 - Oest","Demogràfic","Població assignada de 15-54 anys (n)",6837,5990,12827,2090135,2009939,4100074
"Tortosa 02 - Oest","Demogràfic","Població assignada de 55-64 anys (n)",1649,1684,3333,485653,501618,987271
"Tortosa 02 - Oest","Demogràfic","Població assignada de 65 anys o més (n)",2654,3332,5986,631736,839322,1471058
"Tortosa 02 - Oest","Demogràfic","Població assignada total (n)",13171,12933,26104,3771014,3882239,7653253
"Tremp","Demogràfic","Població assignada de 0-14 anys (n)",490,482,972,563490,531360,1094850
"Tremp","Demogràfic","Població assignada de 15-54 anys (n)",1952,1874,3826,2090135,2009939,4100074
"Tremp","Demogràfic","Població assignada de 55-64 anys (n)",634,584,1218,485653,501618,987271
"Tremp","Demogràfic","Població assignada de 65 anys o més (n)",910,1124,2034,631736,839322,1471058
"Tremp","Demogràfic","Població assignada total (n)",3986,4064,8050,3771014,3882239,7653253
"Ulldecona","Demogràfic","Població assignada de 0-14 anys (n)",821,782,1603,563490,531360,1094850
"Ulldecona","Demogràfic","Població assignada de 15-54 anys (n)",3207,2792,5999,2090135,2009939,4100074
"Ulldecona","Demogràfic","Població assignada de 55-64 anys (n)",800,769,1569,485653,501618,987271
"Ulldecona","Demogràfic","Població assignada de 65 anys o més (n)",1155,1326,2481,631736,839322,1471058
"Ulldecona","Demogràfic","Població assignada total (n)",5983,5669,11652,3771014,3882239,7653253
"Vall del Tenes","Demogràfic","Població assignada de 0-14 anys (n)",2648,2539,5187,563490,531360,1094850
"Vall del Tenes","Demogràfic","Població assignada de 15-54 anys (n)",10156,9485,19641,2090135,2009939,4100074
"Vall del Tenes","Demogràfic","Població assignada de 55-64 anys (n)",2506,2445,4951,485653,501618,987271
"Vall del Tenes","Demogràfic","Població assignada de 65 anys o més (n)",3012,3319,6331,631736,839322,1471058
"Vall del Tenes","Demogràfic","Població assignada total (n)",18322,17788,36110,3771014,3882239,7653253
"Vallirana","Demogràfic","Població assignada de 0-14 anys (n)",1825,1683,3508,563490,531360,1094850
"Vallirana","Demogràfic","Població assignada de 15-54 anys (n)",6048,5860,11908,2090135,2009939,4100074
"Vallirana","Demogràfic","Població assignada de 55-64 anys (n)",1416,1435,2851,485653,501618,987271
"Vallirana","Demogràfic","Població assignada de 65 anys o més (n)",1826,2188,4014,631736,839322,1471058
"Vallirana","Demogràfic","Població assignada total (n)",11115,11166,22281,3771014,3882239,7653253
"Valls Urbà","Demogràfic","Població assignada de 0-14 anys (n)",2084,2052,4136,563490,531360,1094850
"Valls Urbà","Demogràfic","Població assignada de 15-54 anys (n)",7434,6687,14121,2090135,2009939,4100074
"Valls Urbà","Demogràfic","Població assignada de 55-64 anys (n)",1921,1805,3726,485653,501618,987271
"Valls Urbà","Demogràfic","Població assignada de 65 anys o més (n)",2227,2856,5083,631736,839322,1471058
"Valls Urbà","Demogràfic","Població assignada total (n)",13666,13400,27066,3771014,3882239,7653253
"Vandellòs i l'Hospitalet de l'Infant","Demogràfic","Població assignada de 0-14 anys (n)",515,486,1001,563490,531360,1094850
"Vandellòs i l'Hospitalet de l'Infant","Demogràfic","Població assignada de 15-54 anys (n)",1721,1632,3353,2090135,2009939,4100074
"Vandellòs i l'Hospitalet de l'Infant","Demogràfic","Població assignada de 55-64 anys (n)",420,431,851,485653,501618,987271
"Vandellòs i l'Hospitalet de l'Infant","Demogràfic","Població assignada de 65 anys o més (n)",553,669,1222,631736,839322,1471058
"Vandellòs i l'Hospitalet de l'Infant","Demogràfic","Població assignada total (n)",3209,3218,6427,3771014,3882239,7653253
"Vic 01 - Nord","Demogràfic","Població assignada de 0-14 anys (n)",2408,2286,4694,563490,531360,1094850
"Vic 01 - Nord","Demogràfic","Població assignada de 15-54 anys (n)",7906,7230,15136,2090135,2009939,4100074
"Vic 01 - Nord","Demogràfic","Població assignada de 55-64 anys (n)",1667,1730,3397,485653,501618,987271
"Vic 01 - Nord","Demogràfic","Població assignada de 65 anys o més (n)",1995,2876,4871,631736,839322,1471058
"Vic 01 - Nord","Demogràfic","Població assignada total (n)",13976,14122,28098,3771014,3882239,7653253
"Vic 02 - Sud - El Remei","Demogràfic","Població assignada de 0-14 anys (n)",2404,2170,4574,563490,531360,1094850
"Vic 02 - Sud - El Remei","Demogràfic","Població assignada de 15-54 anys (n)",8614,6972,15586,2090135,2009939,4100074
"Vic 02 - Sud - El Remei","Demogràfic","Població assignada de 55-64 anys (n)",1668,1403,3071,485653,501618,987271
"Vic 02 - Sud - El Remei","Demogràfic","Població assignada de 65 anys o més (n)",1500,2012,3512,631736,839322,1471058
"Vic 02 - Sud - El Remei","Demogràfic","Població assignada total (n)",14186,12557,26743,3771014,3882239,7653253
"Viladecans 01","Demogràfic","Població assignada de 0-14 anys (n)",2465,2275,4740,563490,531360,1094850
"Viladecans 01","Demogràfic","Població assignada de 15-54 anys (n)",6161,5777,11938,2090135,2009939,4100074
"Viladecans 01","Demogràfic","Població assignada de 55-64 anys (n)",1318,1276,2594,485653,501618,987271
"Viladecans 01","Demogràfic","Població assignada de 65 anys o més (n)",1670,2158,3828,631736,839322,1471058
"Viladecans 01","Demogràfic","Població assignada total (n)",11614,11486,23100,3771014,3882239,7653253
"Viladecans 02","Demogràfic","Població assignada de 0-14 anys (n)",1015,1081,2096,563490,531360,1094850
"Viladecans 02","Demogràfic","Població assignada de 15-54 anys (n)",5669,5518,11187,2090135,2009939,4100074
"Viladecans 02","Demogràfic","Població assignada de 55-64 anys (n)",1444,1420,2864,485653,501618,987271
"Viladecans 02","Demogràfic","Població assignada de 65 anys o més (n)",1871,2426,4297,631736,839322,1471058
"Viladecans 02","Demogràfic","Població assignada total (n)",9999,10445,20444,3771014,3882239,7653253
"Viladecans 03","Demogràfic","Població assignada de 0-14 anys (n)",1692,1526,3218,563490,531360,1094850
"Viladecans 03","Demogràfic","Població assignada de 15-54 anys (n)",6301,6336,12637,2090135,2009939,4100074
"Viladecans 03","Demogràfic","Població assignada de 55-64 anys (n)",1382,1383,2765,485653,501618,987271
"Viladecans 03","Demogràfic","Població assignada de 65 anys o més (n)",1502,1831,3333,631736,839322,1471058
"Viladecans 03","Demogràfic","Població assignada total (n)",10877,11076,21953,3771014,3882239,7653253
"Vilafant","Demogràfic","Població assignada de 0-14 anys (n)",1150,1120,2270,563490,531360,1094850
"Vilafant","Demogràfic","Població assignada de 15-54 anys (n)",3740,3617,7357,2090135,2009939,4100074
"Vilafant","Demogràfic","Població assignada de 55-64 anys (n)",1005,973,1978,485653,501618,987271
"Vilafant","Demogràfic","Població assignada de 65 anys o més (n)",1244,1492,2736,631736,839322,1471058
"Vilafant","Demogràfic","Població assignada total (n)",7139,7202,14341,3771014,3882239,7653253
"Vilafranca del Penedès 01","Demogràfic","Població assignada de 0-14 anys (n)",1180,1143,2323,563490,531360,1094850
"Vilafranca del Penedès 01","Demogràfic","Població assignada de 15-54 anys (n)",5385,5244,10629,2090135,2009939,4100074
"Vilafranca del Penedès 01","Demogràfic","Població assignada de 55-64 anys (n)",1376,1425,2801,485653,501618,987271
"Vilafranca del Penedès 01","Demogràfic","Població assignada de 65 anys o més (n)",1770,2438,4208,631736,839322,1471058
"Vilafranca del Penedès 01","Demogràfic","Població assignada total (n)",9711,10250,19961,3771014,3882239,7653253
"Vilafranca del Penedès 02","Demogràfic","Població assignada de 0-14 anys (n)",3755,3544,7299,563490,531360,1094850
"Vilafranca del Penedès 02","Demogràfic","Població assignada de 15-54 anys (n)",6777,6554,13331,2090135,2009939,4100074
"Vilafranca del Penedès 02","Demogràfic","Població assignada de 55-64 anys (n)",1291,1302,2593,485653,501618,987271
"Vilafranca del Penedès 02","Demogràfic","Població assignada de 65 anys o més (n)",1460,1921,3381,631736,839322,1471058
"Vilafranca del Penedès 02","Demogràfic","Població assignada total (n)",13283,13321,26604,3771014,3882239,7653253
"Vilanova del Camí","Demogràfic","Població assignada de 0-14 anys (n)",1045,1037,2082,563490,531360,1094850
"Vilanova del Camí","Demogràfic","Població assignada de 15-54 anys (n)",3526,3242,6768,2090135,2009939,4100074
"Vilanova del Camí","Demogràfic","Població assignada de 55-64 anys (n)",845,837,1682,485653,501618,987271
"Vilanova del Camí","Demogràfic","Població assignada de 65 anys o més (n)",983,1204,2187,631736,839322,1471058
"Vilanova del Camí","Demogràfic","Població assignada total (n)",6399,6320,12719,3771014,3882239,7653253
"Vilanova i la Geltrú 01","Demogràfic","Població assignada de 0-14 anys (n)",1917,1879,3796,563490,531360,1094850
"Vilanova i la Geltrú 01","Demogràfic","Població assignada de 15-54 anys (n)",6467,6568,13035,2090135,2009939,4100074
"Vilanova i la Geltrú 01","Demogràfic","Població assignada de 55-64 anys (n)",1782,1909,3691,485653,501618,987271
"Vilanova i la Geltrú 01","Demogràfic","Població assignada de 65 anys o més (n)",2136,2687,4823,631736,839322,1471058
"Vilanova i la Geltrú 01","Demogràfic","Població assignada total (n)",12302,13043,25345,3771014,3882239,7653253
"Vilanova i la Geltrú 02","Demogràfic","Població assignada de 0-14 anys (n)",1320,1242,2562,563490,531360,1094850
"Vilanova i la Geltrú 02","Demogràfic","Població assignada de 15-54 anys (n)",6235,6234,12469,2090135,2009939,4100074
"Vilanova i la Geltrú 02","Demogràfic","Població assignada de 55-64 anys (n)",1621,1710,3331,485653,501618,987271
"Vilanova i la Geltrú 02","Demogràfic","Població assignada de 65 anys o més (n)",2078,2981,5059,631736,839322,1471058
"Vilanova i la Geltrú 02","Demogràfic","Població assignada total (n)",11254,12167,23421,3771014,3882239,7653253
"Vilanova i la Geltrú 03 - Baix-a-Mar","Demogràfic","Població assignada de 0-14 anys (n)",1309,1220,2529,563490,531360,1094850
"Vilanova i la Geltrú 03 - Baix-a-Mar","Demogràfic","Població assignada de 15-54 anys (n)",4621,4566,9187,2090135,2009939,4100074
"Vilanova i la Geltrú 03 - Baix-a-Mar","Demogràfic","Població assignada de 55-64 anys (n)",1158,1167,2325,485653,501618,987271
"Vilanova i la Geltrú 03 - Baix-a-Mar","Demogràfic","Població assignada de 65 anys o més (n)",1533,1921,3454,631736,839322,1471058
"Vilanova i la Geltrú 03 - Baix-a-Mar","Demogràfic","Població assignada total (n)",8621,8874,17495,3771014,3882239,7653253
"Vila-seca","Demogràfic","Població assignada de 0-14 anys (n)",2070,1940,4010,563490,531360,1094850
"Vila-seca","Demogràfic","Població assignada de 15-54 anys (n)",6310,6119,12429,2090135,2009939,4100074
"Vila-seca","Demogràfic","Població assignada de 55-64 anys (n)",1280,1277,2557,485653,501618,987271
"Vila-seca","Demogràfic","Població assignada de 65 anys o més (n)",1535,1807,3342,631736,839322,1471058
"Vila-seca","Demogràfic","Població assignada total (n)",11195,11143,22338,3771014,3882239,7653253
"Vilassar de Dalt","Demogràfic","Població assignada de 0-14 anys (n)",1197,1153,2350,563490,531360,1094850
"Vilassar de Dalt","Demogràfic","Població assignada de 15-54 anys (n)",4097,4059,8156,2090135,2009939,4100074
"Vilassar de Dalt","Demogràfic","Població assignada de 55-64 anys (n)",1126,1135,2261,485653,501618,987271
"Vilassar de Dalt","Demogràfic","Població assignada de 65 anys o més (n)",1373,1574,2947,631736,839322,1471058
"Vilassar de Dalt","Demogràfic","Població assignada total (n)",7793,7921,15714,3771014,3882239,7653253
"Vilassar de Mar","Demogràfic","Població assignada de 0-14 anys (n)",1949,1847,3796,563490,531360,1094850
"Vilassar de Mar","Demogràfic","Població assignada de 15-54 anys (n)",6574,6544,13118,2090135,2009939,4100074
"Vilassar de Mar","Demogràfic","Població assignada de 55-64 anys (n)",1719,1885,3604,485653,501618,987271
"Vilassar de Mar","Demogràfic","Població assignada de 65 anys o més (n)",2273,2868,5141,631736,839322,1471058
"Vilassar de Mar","Demogràfic","Població assignada total (n)",12515,13144,25659,3771014,3882239,7653253
